according to the article they create a lot of greenhouse gases	Meat industry produces greenhouse gases and/or uses water - general
according to the report  just raising the animals creates one-fifth of greenhouse gases.	Meat industry produces greenhouse gases and/or uses water - specific numbers
according to this source-free paragraph it creates nearly 1/5 of all supposedly harmful greenhouse gases.	Meat industry produces greenhouse gases and/or uses water - specific numbers
according to what I just read meat production and transporting it creates almost one-fifth of greenhouse gases and also almost half the water used in the USA goes to raising livestock.	Meat industry produces greenhouse gases and/or uses water - specific numbers
1/5 of our greenhouse gases are caused my the meat industry.	Meat industry produces greenhouse gases and/or uses water - specific numbers
1/5 of the earth's greenhouse gases are from meat transportation, and half of all water used in US goes to raising livestock.	Meat industry produces greenhouse gases and/or uses water - specific numbers
20% of greenhouse gases are due to meat production and almost half of the water used in the United States is for meat.	Meat industry produces greenhouse gases and/or uses water - specific numbers
a fifth of the greenhouse gases are created in the process of raising and transporting animals.	Meat industry produces greenhouse gases and/or uses water - specific numbers
a large portion of greenhouse gasses are caused by raising and transporting meat.	Meat industry produces greenhouse gases and/or uses water - general
a lot of our natural resources are going into raising livestock.	Meat industry produces greenhouse gases and/or uses water - general
almost half of resources are used for livestock.	Meat industry produces greenhouse gases and/or uses water - general
almost one fifth of the earth's greenhouse gasses are produced by meat transportation.	Meat industry produces greenhouse gases and/or uses water - general
almost one fifth of the world's greenhouse gases are created by raising animals and transporting meat.	Meat industry produces greenhouse gases and/or uses water - specific numbers
almost one-fifth of greenhouse gases are generated from raising live stock and half the water consumed in US is used for raising the live stock.	Meat industry produces greenhouse gases and/or uses water - specific numbers
almost one-fifth of the earth's greenhouse gases are produced by raising animals.	Meat industry produces greenhouse gases and/or uses water - specific numbers
animals are dying.	Meat industry harms animals
animals are grown in cafos not small farme where poop becomes veggies	Outside of article's scope
animals are the cause of 1/5 of the greenhouse gases caused.	Meat industry produces greenhouse gases and/or uses water - specific numbers
greenhouse gases are produced.	Meat industry produces greenhouse gases and/or uses water - general
large amounts of greenhouse gasses are generated as a result of meat production.	Meat industry produces greenhouse gases and/or uses water - general
large amounts of resources are needed to raise and transport the livestock, and these activities contribute to greenhouse gas emissions.	Meat industry produces greenhouse gases and/or uses water - general
many greenhouse gasses are emitted in the raising and transporting of livestock for the meat market.	Meat industry produces greenhouse gases and/or uses water - general
more domestic animals that are suppose to complete the Eco circle are killed every day.	Meat industry harms animals
most of our water sources are used for the animals we are raising for meat.	Meat industry produces greenhouse gases and/or uses water - general
natural resources are used raising and transporting products.	Meat industry produces greenhouse gases and/or uses water - general
of all the greenhouse gases that are released during transport of meat.	Because as preposition
of how natural resources  (water, fuel) are used to raise the animals and transport the food.	Because as preposition
of the amount of green house gases that are being produced from the livestock.	Because as preposition
of the gas that the animals are producing harms the Oxygen base.	Because as preposition
of the green house gases that are produced in transporting meat across the country.	Because as preposition
of the greenhouse gases that are created to raise livestock.	Because as preposition
of the greenhouse gases that are produced transporting the meat.	Because as preposition
of the way animals are raised.	Because as preposition
one fifth of greenhouse gases are produced by  raising and transporting livestock	Meat industry produces greenhouse gases and/or uses water - specific numbers
one fifth of the green house gases are from transporting the livestock.	Meat industry produces greenhouse gases and/or uses water - specific numbers
one-fifth of the Earth's green house gas's are being created to transport these meats.	Meat industry produces greenhouse gases and/or uses water - specific numbers
one-fifth of the earth's greenhouse gases are caused by transporting meat.	Meat industry produces greenhouse gases and/or uses water - specific numbers
one-fifth of the earth's greenhouse gases are produced by everything that goes into raising and transporting livestock.	Meat industry produces greenhouse gases and/or uses water - specific numbers
one-fifth of the earth's greenhouse gases are produced by the meat industry.	Meat industry produces greenhouse gases and/or uses water - specific numbers
one-fifth of the earth’s greenhouse gases are being used.	Meat industry produces greenhouse gases and/or uses water - specific numbers
one-fifth of the earth’s greenhouse gases are produced by raising and transporting meat	Meat industry produces greenhouse gases and/or uses water - specific numbers
people are killing all animals; and, normal nature is non-existent in the natural environment today.	Meat industry harms animals
the green house gases that are produced from raising animals for meat and then the transportation involved harms the environment.	Meat industry produces greenhouse gases and/or uses water - general
the lesser those animals are, the more risk of having inbalance in the environment	Meat industry harms environment/uses resources w/o mentioning greenhouse gases or water
the massive amount of farm animals are polluting the planet	Meat industry harms environment/uses resources w/o mentioning greenhouse gases or water
the resources that are involved in the entire process, from "farm to fork" contribute to large amounts of carbon buildup in our atmosphere.	Meat industry produces greenhouse gases and/or uses water - general
the transportation and raising of meat products and animals are contributing about 1/5 of the total greenhouse gases.	Meat industry produces greenhouse gases and/or uses water - general
the way they are transported causes more amounts of greenhouse gases to be released into the environment that many other more prevalent things.	Meat industry produces greenhouse gases and/or uses water - general
there are chemicals created from raising animals.	Meat industry harms environment/uses resources w/o mentioning greenhouse gases or water
there are more efficient ways to get calories.	Outside of article's scope
they are causing green house effects.	Meat industry produces greenhouse gases and/or uses water - general
they are causing greenhouse gases.	Meat industry produces greenhouse gases and/or uses water - general
they are creating a lot of greenhouse gases and hurt the Earth.	Meat industry produces greenhouse gases and/or uses water - general
they are creating an excess of greenhouse gases.	Meat industry produces greenhouse gases and/or uses water - general
they are creating greenhouse admissions.	Meat industry produces greenhouse gases and/or uses water - general
they are creating more greenhouse gases than all of our transportation methods combined.	Meat industry produces greenhouse gases and/or uses water - specific numbers
they are creating one-fifth of the earth's greenhouse gases.	Meat industry produces greenhouse gases and/or uses water - specific numbers
they are creating one-fifth of the eath's greenhouse gases.	Meat industry produces greenhouse gases and/or uses water - specific numbers
they are emitting a ton of greenhouse gases.	Meat industry produces greenhouse gases and/or uses water - general
they are leading to green house gas pollution.	Meat industry produces greenhouse gases and/or uses water - general
they are made in ways that create alot of greenhouse gases.	Meat industry produces greenhouse gases and/or uses water - general
they are putting out more  green house gasses that is coming from all the gasses from shipping these animals for people to eat.	Meat industry produces greenhouse gases and/or uses water - general
they are responsible for almost one-fifth of the earth's greenhouse gases and almost half of the water used in the U.S.	Meat industry produces greenhouse gases and/or uses water - specific numbers
they are the number one contributor to greenhouse gases.	Meat industry produces greenhouse gases and/or uses water - general
too many of earth's resources vital to survival are strictly allocated to raising/distributing meat products.	Meat industry harms environment/uses resources w/o mentioning greenhouse gases or water
we are raising more animal to compensate for demand	Outside of article's scope
we are using greenhouse gases to transport the animals.	Meat industry produces greenhouse gases and/or uses water - general
we are using too many resources that produce green house gases.	Meat industry produces greenhouse gases and/or uses water - general
of greenhouse gases associated with raising meat.	Because as preposition
of the amount of greenhouse gasses  associated with production and transportation of meat.	Because as preposition
of the green house gasses associated with transporting them.	Because as preposition
of the greenhouse gasses associated with raising the animals and transporting them.	Because as preposition
of the large amounts of greenhouse gases associated with raising livestock.	Because as preposition
a large amount of water is used raising livestock.	Meat industry produces greenhouse gases and/or uses water - general
Half of the US water consumption is used for raising livestock.	Meat industry produces greenhouse gases and/or uses water - specific numbers
half of the water in the US is used to take care of livestock.	Meat industry produces greenhouse gases and/or uses water - specific numbers
half the water in the US is used to raise livestock.	Meat industry produces greenhouse gases and/or uses water - specific numbers
it is a large contributor to greenhouse gases.	Meat industry produces greenhouse gases and/or uses water - general
it is a strain on resources, specifically water, as well as hurting the environment by creating greenhouse gases.	Meat industry produces greenhouse gases and/or uses water - general
it is associated with one-fifth of the Earth's greenhouse gases and almost half of the water used in the U.S. goes to livestock.	Plagiarism
it is causing a high-demand of animal livestock that is not sustainable for the environment.	Outside of article's scope
it is causing a very excessive amount of greenhouse gasses.	Meat industry produces greenhouse gases and/or uses water - general
it is causing more sources of transportation to take the animals and crates which is causing greater amount of greenhouse gases.	Meat industry produces greenhouse gases and/or uses water - general
it is contributing almost 20% of greenhouse gases to the Earth's atmosphere.	Meat industry produces greenhouse gases and/or uses water - specific numbers
it is contributing to greenhouse gases.	Meat industry produces greenhouse gases and/or uses water - general
it is creating  almost 1/5 of the earths greenhouse gases.	Meat industry produces greenhouse gases and/or uses water - specific numbers
it is creating a lot of greenhouse gas and using up water.	Meat industry produces greenhouse gases and/or uses water - general
it is creating a lot of greenhouse gases due to raising the livestock and transporting the meat.	Meat industry produces greenhouse gases and/or uses water - general
it is creating green house gassses.	Meat industry produces greenhouse gases and/or uses water - general
it is creating greenhouse gases and uses up a lot of water.	Meat industry produces greenhouse gases and/or uses water - general
it is creating huge amounts of greenhouse gases.	Meat industry produces greenhouse gases and/or uses water - general
it is creating large amounts of greenhouse gases.	Meat industry produces greenhouse gases and/or uses water - general
it is emitting greenhouse gases.	Meat industry produces greenhouse gases and/or uses water - general
it is expanding the green house effect when the meat producing animals are transported.	Meat industry produces greenhouse gases and/or uses water - general
it is hurting the earth by contributing to one-fifth of the earth's greenhouse gases.	Meat industry produces greenhouse gases and/or uses water - specific numbers
it is increasing almost one-fifth of the earth’s greenhouse gases and almost half of the water used in the U.S. goes to raising livestock	Meat industry produces greenhouse gases and/or uses water - specific numbers
it is killing more animals	Meat industry harms animals
it is producing  one-fifth of the earth's greenhouse gases.	Meat industry produces greenhouse gases and/or uses water - specific numbers
it is producing more greenhouse gas than cars, trucks, and trains combined.	Meat industry produces greenhouse gases and/or uses water - specific numbers
it is producing most of the green house gases that are harming the earth	Meat industry produces greenhouse gases and/or uses water - general
it is releasing more green house gases.	Meat industry produces greenhouse gases and/or uses water - general
it is responsible for 1/5 of the earths greenhouse gasses.	Meat industry produces greenhouse gases and/or uses water - specific numbers
it is responsible for one fifths of the greenhouse gas emissions.	Meat industry produces greenhouse gases and/or uses water - specific numbers
it is responsible for over twenty percent of the greenhouse gases.	Meat industry produces greenhouse gases and/or uses water - specific numbers
it is taking animals from the environment with are a part of nature.	Meat industry harms animals
it is terrible for the environment and causes green house gases.	Meat industry produces greenhouse gases and/or uses water - general
meat industry is responsible for contributing to significant amount of earth’s greenhouse gases and uses up large amount of water resources.	Meat industry produces greenhouse gases and/or uses water - general
meat is being made domestically	Irrelevant fact from article
of green house effect is increasing!	Because as preposition
of the amount of green house gas that is produce in 9 rider to transport the meat across region	Because as preposition
of the thought that greenhouse gas is emitted from raising meat and a large amount of water is consumed.	Because as preposition
of what is required to produce enough for everyone.	Because as preposition
one fifth of the earth's greenhouse gases is created by raising livestock and transporting meat.	Meat industry produces greenhouse gases and/or uses water - specific numbers
one fifth of the greenhouse gasses is created by raising and transporting livestock.	Meat industry produces greenhouse gases and/or uses water - specific numbers
one half of the water is used to raise them and 20 Percent of greenhouse gases produced comes from the raising and transportation of meat products.	Meat industry produces greenhouse gases and/or uses water - specific numbers
one half of US water supply is used to raise animals for producing meat.	Meat industry produces greenhouse gases and/or uses water - specific numbers
production and transportation of meat is water-intensive and produces large amounts of greenhouse gases.	Meat industry produces greenhouse gases and/or uses water - general
the greehouse gas that is produced by transporting animals arcoss the US.	Meat industry produces greenhouse gases and/or uses water - general
the meat industry is responsible for 1/5 of the world's greenhouse gases.	Meat industry produces greenhouse gases and/or uses water - specific numbers
the meat industry is responsible for significant greenhouse gas emission and water consumption.	Meat industry produces greenhouse gases and/or uses water - general
the meat that is consumed uses much of our resources just to become food for us.	Meat industry produces greenhouse gases and/or uses water - general
the raising of the animals and transportation of the meats is creating 1/5 of the greenhouse gases on earth.	Meat industry produces greenhouse gases and/or uses water - specific numbers
there is a large amount of greenhouse gases produced.	Meat industry produces greenhouse gases and/or uses water - general
There is so much greenhouse gasses in raising and transporting livestock.	Meat industry produces greenhouse gases and/or uses water - general
there is so much water used to produce meat.	Meat industry produces greenhouse gases and/or uses water - general
this process is responsible for almost one-fifth of the earth's greenhouse gases which is harmful for the environment.	Meat industry produces greenhouse gases and/or uses water - specific numbers
when land is used to raise animals instead of crops, precious water and soil are lost, trees are cut down to make land for grazing or factory-farm sheds, and untreated animal waste pollutes rivers and streams.	Meat industry harms environment/uses resources w/o mentioning greenhouse gases or water
the raising of the animals that become that meat causes 20% of the Earth's greenhouse gases to be created.	Meat industry produces greenhouse gases and/or uses water - specific numbers
it as been through the meat	Insufficient or unintelligible response
of gases being relased	Because as preposition
of its greenhouse gas emissions when being produced and transported.	Because as preposition
of the amount of greenhouse gasses being released.	Because as preposition
of the enormous amount of greenhouse gases being created from the livestock.	Because as preposition
the animals being raised produce greenhouse gases.	Meat industry produces greenhouse gases and/or uses water - general
breeding animals for meat and the associated transportation is the cause of about one-fifth of the world's greenhouse gases.	Meat industry produces greenhouse gases and/or uses water - specific numbers
of greenhouse gases caused through the raising and transport of meat.	Because as preposition
1/5 of the world's greenhouse gases come from raising livestock for consumption.	Meat industry produces greenhouse gases and/or uses water - specific numbers
almost one third of the earths greenhouse gases come from raising animals and transporting them	Meat industry produces greenhouse gases and/or uses water - specific numbers
of the gasses that come out of the cows into the environment.	Because as preposition
of the greenhouse gas emissions that come from the meat industry.	Because as preposition
one fifth of the earth's greenhouse gases comes from raising animals.	Meat industry produces greenhouse gases and/or uses water - specific numbers
of the greenhouse gases coming from raising and transportation of these animals.	Because as preposition
a significant portions of our resources, such as half of the water consumed in the US, are used just to raise the animals, and the raising and transportation of these animals contributes 20% of the greenhouse gases.	Meat industry produces greenhouse gases and/or uses water - specific numbers
the raising and transportation of the consumed animals creates nearly 20% of the Earth's greenhouse gases.	Meat industry produces greenhouse gases and/or uses water - specific numbers
of what it costs in fuel to transport the meat to its destination.	Because as preposition
of all of the pollution created during the production and transportation processes of meat.	Because as preposition
of large amounts of greenhouse gas created in production.	Because as preposition
of the greenhouse gas created from raising and transporting the meat.	Because as preposition
of the greenhouse gas emissions created from raising animals and transporting them	Because as preposition
of the large amount of greenhouse gases created by raising the meat.	Because as preposition
of the large amount of greenhouse gases created.	Because as preposition
a lot of the greenhouse gases emitted are caused by transportation of livestock.	Meat industry produces greenhouse gases and/or uses water - general
of green house gases emitted due to transportation and raising costs.	Because as preposition
of the greenhouse gases emitted, and the huge consumption of water.	Because as preposition
of the greenhouse gasses emitted during the whole process of raising livestock.	Because as preposition
the production of meat equals one half of US water usage and produces large quantities of greenhouse gasses	Meat industry produces greenhouse gases and/or uses water - general
exporting and greenhouse gases increase as a result.	Meat industry produces greenhouse gases and/or uses water - general
feeding the livestock uses a lot of water and transporting the meat releases large amounts CO2 in the atmosphere.	Meat industry produces greenhouse gases and/or uses water - general
the amount of bacteria found in meat can be very harmful to the body	Outside of article's scope
of the green house gases it causes when raising the animal	Because as preposition
of the greenhouse gases it produces, and water it uses.	Because as preposition
of the greenhouse gases that it produces	Because as preposition
of the greenhouse gases the production creates.	Because as preposition
of the green house gasses the animals are releasing.	Because as preposition
of the greenhouse gas production and massive water consumption to generate meat.	Because as preposition
the green house gasses generated from livestock production makes up one fifth of the total earths emissions	Meat industry produces greenhouse gases and/or uses water - specific numbers
half of the US's water go towards the meat industry and 1/5 of greenhouse gases are from meat consumption.	Meat industry produces greenhouse gases and/or uses water - specific numbers
almost half the water in the US goes to livestock production.	Meat industry produces greenhouse gases and/or uses water - specific numbers
half our water goes to livestock	Meat industry produces greenhouse gases and/or uses water - specific numbers
half the water goes to livestock and the green houses are using up gas	Meat industry produces greenhouse gases and/or uses water - general
half the world's water goes to feeding animals.	Meat industry produces greenhouse gases and/or uses water - specific numbers
the amount of time and energy going into raising livestock leaves behind a large carbon footprint.	Meat industry produces greenhouse gases and/or uses water - general
growing and transporting meat is the largest contributor to greenhouse gases, and	Meat industry produces greenhouse gases and/or uses water - general
growing animals and transporting their meat is responsible for almost 20% of the Earth’s greenhouse gases.	Meat industry produces greenhouse gases and/or uses water - specific numbers
overpopulation has created a crisis.	Outside of article's scope
almost have the water in the us goes to livestock	Meat industry produces greenhouse gases and/or uses water - specific numbers
hurting the economy and taking away precious jobs.	Irrelevant fact from article
increased greenhouse gas emissions.	Meat industry produces greenhouse gases and/or uses water - general
of the increased amounts of greenhouse gases that result from it.	Because as preposition
of the increased demand on water resources and high outputs of greenhouse gases.	Because as preposition
of the greenhouse gas emissions and water needs involved in raising livestock.	Because as preposition
the procedures involved in obtaining this meat are responsible for one-fifth of the earth's greenhouse gases.	Meat industry produces greenhouse gases and/or uses water - specific numbers
the process involved with bringing meat to grocery stores takes up quite a large portion of greenhouse gases.	Meat industry produces greenhouse gases and/or uses water - general
meat consumption involves a high amount of green house gas production.	Meat industry produces greenhouse gases and/or uses water - general
many animals killed for it.	Meat industry harms animals
some misinformed malcontents want to push their deceptions.	Outside of article's scope
of massive amounts of water needed for animals and greenhouse gases produced.	Because as preposition
of the greenhouse gasses needed to raise animals	Because as preposition
the care of livestock , the amount of water needed, and  meat product transportation  creates a large amount of greenhouse gases	Meat industry produces greenhouse gases and/or uses water - general
processing meat is using  resources and creating green house gasses.	Meat industry produces greenhouse gases and/or uses water - general
processing meat uses resources and creates pollution.	Meat industry harms environment/uses resources w/o mentioning greenhouse gases or water
the means to produce it is detrimental to the environment	Meat industry harms environment/uses resources w/o mentioning greenhouse gases or water
THEY PRODUCE 1/5 THE GREENHOUSE GASES	Meat industry produces greenhouse gases and/or uses water - specific numbers
greenhouse gasses produced and environmental impact.	Meat industry produces greenhouse gases and/or uses water - specific numbers
Most of the beef produced domestically is eaten by Americans	Irrelevant fact from article
of  the greenhouse gases produced as well as the water amount going toward raising livestock.	Because as preposition
of greenhouse gases produced in raising the animals and transporting the meat.	Because as preposition
of greenhouse gases produced.	Because as preposition
of greenhouse gases that produced by raising livestock as well as transporting animals in vehicles.	Because as preposition
of the amount of greenhouse gases produced by transporting and raising meat and animals	Because as preposition
of the amount of greenhouse gases produced during the production and transportation of meat	Because as preposition
of the green house gasses produced.	Because as preposition
of the greenhouse gases produced and quantity of water consumed in the production of meat.	Because as preposition
of the greenhouse gases produced.	Because as preposition
one -fifth of the greenhouse gasses produced are a result of raising animals for slaughter.	Meat industry produces greenhouse gases and/or uses water - specific numbers
produced domestically is eaten by Americans	Irrelevant fact from article
the green house gas produced during meat processing is huge	Meat industry produces greenhouse gases and/or uses water - general
by producing meat to eat,the process of it creates almost one-fifth of the earth’s greenhouse gases.	Meat industry produces greenhouse gases and/or uses water - specific numbers
producing and transmitting meat produces a significant portion of the world's pollution, and raising the animals uses a lot of our water supply.	Meat industry produces greenhouse gases and/or uses water - general
producing and transporting meat generate almost one-fifth of the earth’s greenhouse gases and waste almost half of the water used in the U.S.	Meat industry produces greenhouse gases and/or uses water - specific numbers
producing meat generates one-fifth of the greenhouse gases and comprises fifty-percent of total U.S. water consumption.	Meat industry produces greenhouse gases and/or uses water - specific numbers
producing meat means producing greenhouse gases and using up half the water used in the US.	Meat industry produces greenhouse gases and/or uses water - general
producing them increases greenhouse gases.	Meat industry produces greenhouse gases and/or uses water - general
the process of producing meat creates almost 1/5 of the earth’s pollution.	Meat industry produces greenhouse gases and/or uses water - specific numbers
the raising, producing and transporting meat increases green house gasses.	Meat industry produces greenhouse gases and/or uses water - general
the process to raise animals for consumption creates a significant portion of the earth's greenhouse gases.	Meat industry produces greenhouse gases and/or uses water - general
animals raised for food are responsible for 1/5 of all greenhouse gas production.	Meat industry produces greenhouse gases and/or uses water - general
the animals raised and the exhaust created by transportation are large contributors to greenhouse gas.	Meat industry produces greenhouse gases and/or uses water - general
between raising livestock and transporting said livestock about one fifth of all greenhouse gasses are created as well as over half of the water in america is going to livestock.	Meat industry produces greenhouse gases and/or uses water - specific numbers
greenhouse gas emissions and a large usage of water for raising cattle.	Meat industry produces greenhouse gases and/or uses water - general
in raising animals and transporting meat almost one-fifth of the earth’s greenhouse gases are created.	Meat industry produces greenhouse gases and/or uses water - specific numbers
raising all the animals and transporting meat creates at least one-fifth of the earth’s greenhouse gases.	Meat industry produces greenhouse gases and/or uses water - specific numbers
raising and transpiring meat creates almost one fifth of the earths greenhouse gases.	Plagiarism
raising and transportation of meats is causing one-fifth of greenhouse gases.	Meat industry produces greenhouse gases and/or uses water - specific numbers
raising and transporting animal creates one fifth of the worlds greenhouse gases.	Meat industry produces greenhouse gases and/or uses water - specific numbers
raising and transporting animals accounts for 20% of greenhouse gases.	Meat industry produces greenhouse gases and/or uses water - specific numbers
raising and transporting animals and meat produces 1/5 of greenhouse gases.	Meat industry produces greenhouse gases and/or uses water - specific numbers
raising and transporting animals contributes to one-fifth of the earth's greenhouse gases.	Meat industry produces greenhouse gases and/or uses water - specific numbers
raising and transporting animals creates a lot of greenhouse gas, and uses a lot of natural resources.	Meat industry produces greenhouse gases and/or uses water - general
raising and transporting animals creates about 1/5 of the earth's greenhouse gases.	Meat industry produces greenhouse gases and/or uses water - specific numbers
raising and transporting animals creates about 1/5 of the Earth's greenhouse gases.	Meat industry produces greenhouse gases and/or uses water - specific numbers
raising and transporting animals creates almost one-fifth of the earth's green house gases.	Plagiarism
raising and transporting animals creates greenhouse gases.	Meat industry produces greenhouse gases and/or uses water - general
raising and transporting animals creates harmful greenhouse gases.	Meat industry produces greenhouse gases and/or uses water - general
raising and transporting animals creates more greenhouse gasses than is produced by automobiles.	Meat industry produces greenhouse gases and/or uses water - specific numbers
raising and transporting animals creates over one-fifth of the earth's greenhouse gasses.	Meat industry produces greenhouse gases and/or uses water - specific numbers
raising and transporting animals for meat consumption are creating  1/5 of the greenhouse gases.	Meat industry produces greenhouse gases and/or uses water - specific numbers
raising and transporting animals largely contributes to the production of greenhouse gases as well as strains other resources such as water.	Meat industry produces greenhouse gases and/or uses water - general
raising and transporting animals produces 1/5 of earth's greenhouse gases.	Meat industry produces greenhouse gases and/or uses water - specific numbers
raising and transporting beef produces a large amount of greenhouse gases and consumes large amounts of water.	Meat industry produces greenhouse gases and/or uses water - general
raising and transporting live-stock adds large amounts of greenhouse gasses to our planet's atmosphere.	Meat industry produces greenhouse gases and/or uses water - general
raising and transporting livestock accounts for 20 percent of the earth's greenhouse gases.	Meat industry produces greenhouse gases and/or uses water - specific numbers
raising and transporting livestock causes 1/5 of all green house gases.	Meat industry produces greenhouse gases and/or uses water - specific numbers
raising and transporting livestock creates a massive amount of greenhouse gases.	Meat industry produces greenhouse gases and/or uses water - general
raising and transporting livestock creates almost 1/5 of greenhouse gases of various transportation means, as well as consuming a vast amount of water resources.	Meat industry produces greenhouse gases and/or uses water - specific numbers
raising and transporting livestock creates almost one fifth of the earth's greenhouse gases.	Plagiarism
raising and transporting livestock creates almost one fifth of the earth's greenhouse gases.	Plagiarism
raising and transporting livestock effects greenhouse gasses.	Meat industry produces greenhouse gases and/or uses water - general
raising and transporting livestock emits a lot of greenhouse gasses	Meat industry produces greenhouse gases and/or uses water - general
raising and transporting livestock for consumption creates approximately 20% of the world's greenhouse gases.	Meat industry produces greenhouse gases and/or uses water - specific numbers
raising and transporting livestock increases greenhouse gas emissions and requires massive amounts of water.	Meat industry produces greenhouse gases and/or uses water - general
raising and transporting livestock is causing a large portion of the greenhouse gases produced.	Meat industry produces greenhouse gases and/or uses water - general
raising and transporting livestock produces greenhouse gases, likely from the burning of fossil fuels and emissions from livestock, and consumes a lot of water.	Meat industry produces greenhouse gases and/or uses water - general
raising and transporting livestock uses precious resources.	Meat industry harms environment/uses resources w/o mentioning greenhouse gases or water
raising and transporting meat accounts for one fifth of the earth's greenhouse gases.	Meat industry produces greenhouse gases and/or uses water - specific numbers
raising and transporting meat causes greenhouse gases and too much water is used.	Meat industry produces greenhouse gases and/or uses water - general
raising and transporting meat causes nearly a fifth of greenhouse gases.	Meat industry produces greenhouse gases and/or uses water - specific numbers
raising and transporting meat causes one fifth of greenhouse gas emissions.	Meat industry produces greenhouse gases and/or uses water - specific numbers
raising and transporting meat creates almost 1/5 of the earth's greenhouse gases.	Plagiarism
raising and transporting meat creates almost 1/5 of the earth's greenhouse gases.	Plagiarism
raising and transporting meat creates almost one-fifth of the earth's greenhouse gases and accounts for almost half of the water used in the U.S.	Plagiarism
raising and transporting meat creates almost one-fifth of the earth's greenhouse gases.	Plagiarism
raising and transporting meat creates almost one-fifth of the earth’s greenhouse gases.	Plagiarism
raising and transporting meat creates alost one-fifth of the earth's greenhouse gasses.	Plagiarism
raising and transporting meat creates greenhouse gases.	Meat industry produces greenhouse gases and/or uses water - general
raising and transporting meat creates more greenhouse gases than driving most vehicles combined.	Meat industry produces greenhouse gases and/or uses water - specific numbers
raising and transporting meat creates one-fifth of the planet's greenhouse gases.	Meat industry produces greenhouse gases and/or uses water - specific numbers
raising and transporting meat creates one-fifth of the world's greenhouse gases	Meat industry produces greenhouse gases and/or uses water - specific numbers
raising and transporting meat generates almost 1/5 of the world's greenhouse gasses.	Meat industry produces greenhouse gases and/or uses water - specific numbers
raising and transporting meat increases greenhouse gases.	Meat industry produces greenhouse gases and/or uses water - general
raising and transporting meat is causing greenhouse gases on the earth.	Meat industry produces greenhouse gases and/or uses water - general
raising and transporting meat is responsible for creating around one-fifth of the earth's greenhouse gases.	Meat industry produces greenhouse gases and/or uses water - specific numbers
raising and transporting meat make us 1/5 of the greenhouse gasses.	Meat industry produces greenhouse gases and/or uses water - specific numbers
raising and transporting meat makes up almost one-fifth of the Earth's greenhouse gases.	Meat industry produces greenhouse gases and/or uses water - specific numbers
raising and transporting meats produces one fifth of greenhouse gases on the earth.	Meat industry produces greenhouse gases and/or uses water - specific numbers
raising and transporting the animal creates 1/5 of the earth's greenhouse gases.	Meat industry produces greenhouse gases and/or uses water - specific numbers
raising and transporting the animals creates a large amount of greenhouse gases.	Meat industry produces greenhouse gases and/or uses water - general
raising and transporting the livestock create one-fifth of  the earths green house gas emissions	Meat industry produces greenhouse gases and/or uses water - specific numbers
raising and transporting them causes nearly one-fifth of the planet's greenhouse gases.	Meat industry produces greenhouse gases and/or uses water - specific numbers
raising and transporting them is creating a staggering amount of greenhouse gases and using  a lot of our drinking water.	Meat industry produces greenhouse gases and/or uses water - general
raising animal and transporting them is causing a great deal of greenhouse gases which impacts the earth neagatively.	Meat industry produces greenhouse gases and/or uses water - general
raising animal and transporting them to slaughter houses creates almost one-fifth of the earth's greenhouse gases.	Meat industry produces greenhouse gases and/or uses water - specific numbers
raising animals and moving meat creates one fifth of the greenhouse gasses globally	Meat industry produces greenhouse gases and/or uses water - specific numbers
raising animals and producing consumable meat products is harmful to the environment.	Meat industry harms environment/uses resources w/o mentioning greenhouse gases or water
raising animals and slaughtering them for meat as well as transporting that meat contribute to 1/5 of all greenhouse gases.	Meat industry produces greenhouse gases and/or uses water - specific numbers
raising animals and the transport of the meat produced from those animals attributes to 20 percent of greenhouse gases found in the earth.	Meat industry produces greenhouse gases and/or uses water - specific numbers
raising animals and transportating meat creates almost one fifth of the earth's greenhouse gases.	Plagiarism
raising animals and transportation of meat uses a significant amount of the earth's greenhouses gases, while the raising of livestock also uses half of the water used in the U.S.	Meat industry produces greenhouse gases and/or uses water - general
raising animals and transporting animal meat results in about one-fifth of harmful greenhouse gases.	Meat industry produces greenhouse gases and/or uses water - specific numbers
raising animals and transporting animals increases greenhouse gases.	Meat industry produces greenhouse gases and/or uses water - general
raising animals and transporting creates greenhouse gases.	Meat industry produces greenhouse gases and/or uses water - general
raising animals and transporting mean creates a lot of greenhouse gases.	Plagiarism
raising animals and transporting mean creates almost 1/5 of the earth's greenhouse gases.	Plagiarism
raising animals and transporting mean creates almost one-fifth of the earth's greenhouse gases.	Plagiarism
raising animals and transporting meat  creates almost one fifth of the earth's green house gasses	Plagiarism
raising animals and transporting meat accounts for more than one-fifth of the Earth's greenhouse gasses.	Meat industry produces greenhouse gases and/or uses water - specific numbers
raising animals and transporting meat causes almost one-fifth of the earth's greenhouse gases.	Meat industry produces greenhouse gases and/or uses water - specific numbers
raising animals and transporting meat causes one-fifth of the earth's greenhouse gases.	Meat industry produces greenhouse gases and/or uses water - specific numbers
raising animals and transporting meat contribute to a large amount of greenhouse gasses.	Meat industry produces greenhouse gases and/or uses water - general
raising animals and transporting meat contributes almost 20% of the earth's greenhouse gases.	Meat industry produces greenhouse gases and/or uses water - specific numbers
raising animals and transporting meat contributes to greenhouse gases in the atmosphere.	Meat industry produces greenhouse gases and/or uses water - general
raising animals and transporting meat create almost one-fifth of the earths greenhouse gases.	Plagiarism
raising animals and transporting meat create one-fifth of the earth's greenhouse gases.	Plagiarism
raising animals and transporting meat creates  greenhouse gases.	Plagiarism
raising animals and transporting meat creates 1/5 of the earth's greenhouse gases.	Plagiarism
raising animals and transporting meat creates a large portion of the earth's green house gases.	Plagiarism
raising animals and transporting meat creates a lot of greenhouse gases and uses a lot of water.	Plagiarism
raising animals and transporting meat creates a lot of greenhouse gases, which are bad for the environment.	Plagiarism
raising animals and transporting meat creates a rise in greenhouse gases.	Plagiarism
raising animals and transporting meat creates a significant amount of greenhouse gases.	Plagiarism
raising animals and transporting meat creates a very large amount of greenhouse gasses.	Plagiarism
raising animals and transporting meat creates about one-fifth of the earth’s greenhouse gases.	Plagiarism
raising animals and transporting meat creates almost 1/5 of all greenhouse gas.	Plagiarism
raising animals and transporting meat creates almost 1/5 of the Earth's greenhouse gases.	Plagiarism
raising animals and transporting meat creates almost 1/5 of the earth's greenhouse gases.	Plagiarism
raising animals and transporting meat creates almost 1/5 of the earth's greenhouse gases.	Plagiarism
raising animals and transporting meat creates almost 1/5 of the earths greenhouse gases.	Plagiarism
raising animals and transporting meat creates almost 1/5th of the earth's greenhouse gases.	Plagiarism
raising animals and transporting meat creates almost 20% of the world's greenhouse gases.	Plagiarism
raising animals and transporting meat creates almost a fifth of the world's greenhouse gas emissions.	Plagiarism
raising animals and transporting meat creates almost one-fifth of Earth's greenhouse gases which is more than what is produced by cars, trucks, trains, and airplanes combined.	Plagiarism
raising animals and transporting meat creates almost one-fifth of the earth's greenhouse gases	Plagiarism
raising animals and transporting meat creates almost one-fifth of the earth's greenhouse gases as well as almost half of the water used in the U.S goes to raising livestock.	Plagiarism
raising animals and transporting meat creates almost one-fifth of the earth's greenhouse gases which is harmful to the environment.	Plagiarism
raising animals and transporting meat creates almost one-fifth of the Earth's greenhouse gases.	Plagiarism
raising animals and transporting meat creates almost one-fifth of the earth's greenhouse gases.	Plagiarism
raising animals and transporting meat creates almost one-fifth of the earth's greenhouse gases.	Plagiarism
raising animals and transporting meat creates almost one-fifth of the Earth's greenhouse gases.	Plagiarism
raising animals and transporting meat creates almost one-fifth of the earth's greenhouse gases.	Plagiarism
raising animals and transporting meat creates almost one-fifth of the earth's greenhouse gasses.	Plagiarism
raising animals and transporting meat creates almost one-fifth of the earth’s  greenhouse gases.	Plagiarism
raising animals and transporting meat creates almost one-fifth of the earth’s greenhouse gases	Plagiarism
Raising animals and transporting meat creates almost one-fifth of the earth’s greenhouse gases	Plagiarism
Raising animals and transporting meat creates almost one-fifth of the earth’s greenhouse gases	Plagiarism
raising animals and transporting meat creates almost one-fifth of the earth’s greenhouse gases and almost half of the water used in the U.S. goes to raising livestock.	Plagiarism
Raising animals and transporting meat creates almost one-fifth of the earth’s greenhouse gases which are produced by cars, trucks, trains, and airplanes	Plagiarism
raising animals and transporting meat creates almost one-fifth of the earth’s greenhouse gases, more than gases produced by cars, trucks, trains, and airplanes combined, and almost half of the water used in the U.S. goes to raising livestock.	Plagiarism
raising animals and transporting meat creates almost one-fifth of the earth’s greenhouse gases.	Plagiarism
raising animals and transporting meat creates almost one-fifth of the earth’s greenhouse gases.	Plagiarism
Raising animals and transporting meat creates almost one-fifth of the earth’s greenhouse gases.	Plagiarism
Raising animals and transporting meat creates almost one-fifth of the earth’s greenhouse gases.	Plagiarism
raising animals and transporting meat creates almost one-fifth of the earth’s greenhouse gases.	Plagiarism
raising animals and transporting meat creates almost one-fifth of the earths greenhouse gases.	Plagiarism
raising animals and transporting meat creates almost one-fifth of the world's greenhouse gases, more than the gases emitted from trucks, cars, trains and airplanes combined.	Plagiarism
raising animals and transporting meat creates almost one-fith of the earths greenhouse gases.	Plagiarism
raising animals and transporting meat creates almostone fifth of the earth’s greenhouse gases.	Plagiarism
raising animals and transporting meat creates green house gases.	Plagiarism
raising animals and transporting meat creates greenhouse gases and also uses a los of water	Plagiarism
raising animals and transporting meat creates greenhouse gases.	Plagiarism
raising animals and transporting meat creates large amounts of greenhouse gasses.	Plagiarism
raising animals and transporting meat creates more greenhouse gases than produced by cars, trucks, airplanes, and trains combined, as well as half of U.S. water goes to raising livestock.	Plagiarism
raising animals and transporting meat creates nearly one fifth of Earth's greenhouse gasses.	Plagiarism
raising animals and transporting meat creates nearly one-fifth of the world's greenhouse gases.	Plagiarism
raising animals and transporting meat creates one fifth of the Earth's greenhouse gases and	Plagiarism
raising animals and transporting meat creates one fifth of the earth's greenhouse gases.	Plagiarism
raising animals and transporting meat creates one-fifth of earth’s greenhouse gases and raising livestock consumes about half the water in the USA.	Plagiarism
raising animals and transporting meat creates one-fifth of the earth's greenhouse gas.	Plagiarism
raising animals and transporting meat creates one-fifth of the earth's greenhouse gases.	Plagiarism
raising animals and transporting meat creates one-fifth of the earth’s greenhouse gases.	Plagiarism
raising animals and transporting meat creates pollution which affect the earth greenhouse gases.	Plagiarism
raising animals and transporting meat creates so much of the earth's greenhouse gases.	Plagiarism
raising animals and transporting meat creates too much (nearly one-fifth) of the Earth's greenhouse gases.	Plagiarism
raising animals and transporting meat is creating greenhouse gasses that exceeds the amount  created by vehicles.	Meat industry produces greenhouse gases and/or uses water - specific numbers
RAISING ANIMALS AND TRANSPORTING MEAT IS RESPONSIBLE FOR CREATING 1/5 OF THE EARTH'S GREENSHOUSE GASES	Meat industry produces greenhouse gases and/or uses water - specific numbers
raising animals and transporting meat is responsible for one-fifth of the earth’s greenhouse gases.	Meat industry produces greenhouse gases and/or uses water - specific numbers
raising animals and transporting meat produces  one fifth of the earth's greenhouse gases.	Meat industry produces greenhouse gases and/or uses water - specific numbers
raising animals and transporting meat produces high amounts of greenhouse gasses.	Meat industry produces greenhouse gases and/or uses water - general
raising animals and transporting meat produces more greenhouse gases.	Meat industry produces greenhouse gases and/or uses water - general
raising animals and transporting meat releases massive amounts of greenhouse gases.	Meat industry produces greenhouse gases and/or uses water - general
raising animals and transporting meat uses almost half of the water used in the U.S. and creates almost one-fifth of the Earth's greenhouse gases.	Meat industry produces greenhouse gases and/or uses water - specific numbers
raising animals and transporting meat uses almost half the water in the U.S. and creates almost one-fifth of the earth's greenhouse gases.	Meat industry produces greenhouse gases and/or uses water - specific numbers
raising animals and transporting meats cause almost one-fifth of greenhouse gases on earth.	Meat industry produces greenhouse gases and/or uses water - specific numbers
raising animals and transporting meats causes almost one-fifth of the world's greenhouse gasses, more than that of airplanes, cars, trucks and trains.	Meat industry produces greenhouse gases and/or uses water - specific numbers
raising animals and transporting meats causes greenhouse gases.	Meat industry produces greenhouse gases and/or uses water - general
raising animals and transporting meats produce 1/5 of earths greenhouse gases.	Meat industry produces greenhouse gases and/or uses water - specific numbers
raising animals and transporting meats result in large amounts of greenhouse gases.	Meat industry produces greenhouse gases and/or uses water - general
raising animals and transporting the meat cause more greenhouse gases than all types of vehicles combined.	Meat industry produces greenhouse gases and/or uses water - specific numbers
raising animals and transporting the meat generates almost 20% of earth's greenhouse gases.	Meat industry produces greenhouse gases and/or uses water - specific numbers
raising animals and transporting thee meat creates 1/5 of the earth greenhouse gases.	Meat industry produces greenhouse gases and/or uses water - specific numbers
raising animals and transporting them account for 20% of greenhouse gases on earth.	Meat industry produces greenhouse gases and/or uses water - specific numbers
raising animals and transporting them allegedly produces one fifth of the earth's greenhouse gases.	Meat industry produces greenhouse gases and/or uses water - specific numbers
raising animals and transporting them contributes to one-fifth of the earth's greenhouse gases.	Meat industry produces greenhouse gases and/or uses water - specific numbers
raising animals and transporting them create almost one fifth of greenhouse gases.	Meat industry produces greenhouse gases and/or uses water - specific numbers
raising animals and transporting them creates about one-fifth of the world's greenhouse gases and they take half the US supply of water.	Meat industry produces greenhouse gases and/or uses water - specific numbers
raising animals and transporting them creates about one-fifth of the world's greenhouse gases.	Meat industry produces greenhouse gases and/or uses water - specific numbers
raising animals and transporting them creates one fifth of the world's greenhouse gases.	Meat industry produces greenhouse gases and/or uses water - specific numbers
raising animals and transporting them produce high amounts of  greenhouse gases	Meat industry produces greenhouse gases and/or uses water - general
raising animals are creating one- fifth of the earth's greenhouse gasses.	Meat industry produces greenhouse gases and/or uses water - specific numbers
raising animals consumes half of the water in the U.S. as well as the damaging greenhouse gases.	Meat industry produces greenhouse gases and/or uses water - general
raising animals contributes too much greenhouse gases.	Meat industry produces greenhouse gases and/or uses water - general
raising animals creates 1/5 of earths greenhouse gases	Meat industry produces greenhouse gases and/or uses water - specific numbers
raising animals creates 1/5 of the earth's greenhouse gases.	Meat industry produces greenhouse gases and/or uses water - specific numbers
raising animals creates a fifth of the world's CO2 emissions	Meat industry produces greenhouse gases and/or uses water - specific numbers
raising animals creates a large amount of greenhouse gases.	Meat industry produces greenhouse gases and/or uses water - general
raising animals creates a large percentage of the earth's greenhouse gasses, and contributes to global warming.	Meat industry produces greenhouse gases and/or uses water - general
raising animals creates almost more than one fifth of the green house gases, and that is more than the gases produced by trucks, cars etc.	Meat industry produces greenhouse gases and/or uses water - specific numbers
raising animals creates greenhouse gases.	Meat industry produces greenhouse gases and/or uses water - general
raising animals creates harmful greenhouse gases.	Meat industry produces greenhouse gases and/or uses water - general
raising animals for consumption is the source of one fifth of all green house gases.	Meat industry produces greenhouse gases and/or uses water - specific numbers
raising animals for food accounts for almost one-fifth of the earth's greenhouse gas emissions and uses almost half of the water used in the U.S.	Meat industry produces greenhouse gases and/or uses water - specific numbers
raising animals for food cause water pollution and animals suffering.	Meat industry harms environment/uses resources w/o mentioning greenhouse gases or water
raising animals for food creates large amounts of greenhouses gasses that contribute to global warming and half of the water we use is used on raising livestock for food.	Meat industry produces greenhouse gases and/or uses water - general
Raising animals for food requires massive amounts of land, food, energy, and water and causes immense animal suffering.	Meat industry harms environment/uses resources w/o mentioning greenhouse gases or water
raising animals for food uses excessive amounts of natural resources such as water and produces a lot of greenhouse gas.	Meat industry produces greenhouse gases and/or uses water - general
raising animals for meat consumption creates almost one fifth of the earth's green house gases.	Meat industry produces greenhouse gases and/or uses water - specific numbers
raising animals for meat contributes almost 1/5 of the earth's greenhouse gasses.	Meat industry produces greenhouse gases and/or uses water - specific numbers
raising animals for the meat causes about one-fifth of the greenhouse gases found on earth.	Meat industry produces greenhouse gases and/or uses water - specific numbers
raising animals increases greenhouse gases.	Meat industry produces greenhouse gases and/or uses water - general
raising animals to eat creates one fifth of the earth's greenhouse gases.	Meat industry produces greenhouse gases and/or uses water - specific numbers
raising animals uses a lot of water and creates green house gases.	Meat industry produces greenhouse gases and/or uses water - general
raising cattle and shipping out the meat causes more gas in the environment than cars, trucks and planes put together.	Meat industry produces greenhouse gases and/or uses water - specific numbers
raising domestic livestock is not efficient	Outside of article's scope
raising farm animals and transporting the meat creates almost one-fifth of the earth’s greenhouse gases.	Meat industry produces greenhouse gases and/or uses water - specific numbers
raising livestock accounts for 1/5 of all greenhouse gases.	Meat industry produces greenhouse gases and/or uses water - specific numbers
raising livestock and transportation for slaughter and consumption produces one fifth of the earths greenhouse gases.	Meat industry produces greenhouse gases and/or uses water - specific numbers
raising livestock and transporting meat generates large amounts of greenhouse gases.	Meat industry produces greenhouse gases and/or uses water - general
raising livestock and transporting meat produces almost one-fifth of the earth's greenhouse gases.	Meat industry produces greenhouse gases and/or uses water - specific numbers
raising livestock and transporting the meat produces almost one-fifth of our earth's greenhouse gases and uses a lot of water.	Meat industry produces greenhouse gases and/or uses water - specific numbers
raising livestock consumes a lot of water.	Meat industry produces greenhouse gases and/or uses water - general
raising livestock create almost one-fifth of the Earth's greenhouse gases	Meat industry produces greenhouse gases and/or uses water - specific numbers
raising livestock creates a large amount of greenhouse gases.	Meat industry produces greenhouse gases and/or uses water - general
raising livestock emits a large amount of greenhouse gases and a huge quantity of water.	Meat industry produces greenhouse gases and/or uses water - general
raising livestock for consumption creates 1/5th of the earth's greenhouse gases, and uses large amounts of water.	Meat industry produces greenhouse gases and/or uses water - specific numbers
raising livestock for meat causes 1/5 of the greenhouse gasses emitted and uses half of the water in the US.	Meat industry produces greenhouse gases and/or uses water - specific numbers
raising livestock is a strain on the environment.	Meat industry harms environment/uses resources w/o mentioning greenhouse gases or water
raising livestock is creating an enormous amount of greenhouse gasses,	Meat industry produces greenhouse gases and/or uses water - general
raising livestock produces more greenhouse gas.	Meat industry produces greenhouse gases and/or uses water - general
raising livestock requires a lot of water, and transporting meat produces a large amount of greenhouse gases.	Meat industry produces greenhouse gases and/or uses water - general
raising livestock takes up greenhouse gases	Meat industry produces greenhouse gases and/or uses water - general
raising livestock uses half the water in the US and contributes to 1/5 of greenhouse gases globally.	Meat industry produces greenhouse gases and/or uses water - specific numbers
raising livestock wastes more water and animals need to consume more plants or vegetation relative the the meats being yielded.	Meat industry harms environment/uses resources w/o mentioning greenhouse gases or water
raising livextock uses a great deal of the water supply, and the transportation of livestock creates greenhouse gases.	Meat industry produces greenhouse gases and/or uses water - general
raising meat and transporting it creates massive amounts of greenhouse gases.	Meat industry produces greenhouse gases and/or uses water - general
raising meat and transporting it is creating more greenhouse gases in one year than all the buses, planes and vehicles create in the same time.	Meat industry produces greenhouse gases and/or uses water - specific numbers
raising meat causes greenhouse gases far in excess of anything else.	Meat industry produces greenhouse gases and/or uses water - general
raising meat consumes large amounts of water.	Meat industry produces greenhouse gases and/or uses water - general
raising meat creates a lot of greenhouse gases and uses a lot of water.	Meat industry produces greenhouse gases and/or uses water - general
raising of animals produces about one-fifth of the earth's greenhouse gases	Meat industry produces greenhouse gases and/or uses water - specific numbers
raising the animals and transporting the meat is responsible for 1/5 of the greenhouse gas emitted on earth.	Meat industry produces greenhouse gases and/or uses water - specific numbers
raising the animals and transporting their meat makes up 20% of greenhouse gases.	Meat industry produces greenhouse gases and/or uses water - specific numbers
raising the animals create a lot of greenhouse gas.	Meat industry produces greenhouse gases and/or uses water - general
raising the animals creates even more greenhouse gas emissions into the atmosphere.	Meat industry produces greenhouse gases and/or uses water - general
raising the animals for mear creates alot of greenhouse gasses.	Meat industry produces greenhouse gases and/or uses water - general
raising the animals that will be eaten produces one-fifth of the world's greenhouse gases and uses a huge amount of water.	Meat industry produces greenhouse gases and/or uses water - specific numbers
raising the livestock and transporting it accounts for almost 1/5 of the earth's greenhouse gases	Meat industry produces greenhouse gases and/or uses water - specific numbers
raising the livestock and transporting meat produces one-fifth of the earth's greenhouse gases, which is more than that produced by cars, trucks, trains, and airplanes combined.	Meat industry produces greenhouse gases and/or uses water - specific numbers
raising the livestock requires alot of water.	Meat industry produces greenhouse gases and/or uses water - general
raising the meat creates a lot of greenhouse gases.	Meat industry produces greenhouse gases and/or uses water - general
raising them created greenhouse gases.	Meat industry produces greenhouse gases and/or uses water - general
supposedly raising animals and transporting meat creates a fifth ofthe earth’s greenhouse gases	Plagiarism
the actions of raising and transporting the livestock consumes a lot of resources.	Meat industry produces greenhouse gases and/or uses water - general
the cost of raising and transporting animals creates a large amount of greenhouse gases that harm the earth.	Meat industry produces greenhouse gases and/or uses water - general
the environmental impact of raising and transporting meat products  exceeds that of cars, trucks, planes, and trains combined.	Meat industry harms environment/uses resources w/o mentioning greenhouse gases or water
the greenhouse gases by raising and transporting meat.	Meat industry produces greenhouse gases and/or uses water - general
the greenhouse gases from raising and transporting meat is extremely large and the amount of water needed to raise meat for food is very great.	Meat industry produces greenhouse gases and/or uses water - general
the process of raising and transporting the animals creates almost a fifth of the world's greenhouse gases.	Meat industry produces greenhouse gases and/or uses water - specific numbers
the process of raising and transporting the animals produces a whole 1/5 of the world's greenhouse gases resulting in warmer climates.	Meat industry produces greenhouse gases and/or uses water - specific numbers
the process of raising animals and transporting meat creates almost one-fifth of the earth’s greenhouse gases.	Plagiarism
the process of raising animals and transporting them creates enormous amounts of greenhouse gasses that are released into the atmosphere.	Meat industry produces greenhouse gases and/or uses water - general
the raising and transporting involved contribute greatly to greenhouse gases and about half of the water used in the US goes to raising livestock.	Meat industry produces greenhouse gases and/or uses water - general
the raising and transporting meat creates more greenhouse gases than that produce by cars, trucks, trains & airplanes put together.	Meat industry produces greenhouse gases and/or uses water - specific numbers
the raising and transporting of animals for consumption produces a large amount of greenhouse gases.	Meat industry produces greenhouse gases and/or uses water - general
the raising and transporting of meat creates one fifth of earths greenhouse gases.	Meat industry produces greenhouse gases and/or uses water - specific numbers
the raising and transporting of meat creates one-fifth of earth's greenhouse gases.	Meat industry produces greenhouse gases and/or uses water - specific numbers
the raising and transporting of meat is a large contributor  of green house gases	Meat industry produces greenhouse gases and/or uses water - general
the raising and transporting of the food animals contributes to global warming.	Meat industry harms environment/uses resources w/o mentioning greenhouse gases or water
rearing livestock is responsible for a fifth of greenhouse gases which harm the environment.	Meat industry produces greenhouse gases and/or uses water - specific numbers
greenhouse emissions released while raising animals and processing meat further speeds up the process of climate change.	Meat industry produces greenhouse gases and/or uses water - general
of the amount of greenhouse gases released to produce the meat.	Because as preposition
of the amount of enegry required to grow, produce and transport meat	Because as preposition
of the vehicles required to move them	Because as preposition
the amount of energy required to support livestock and the resulting supply chain is immense.	Meat industry harms environment/uses resources w/o mentioning greenhouse gases or water
they result in significant amounts of greenhouse gas emissions.	Meat industry produces greenhouse gases and/or uses water - general
of the greenhouse gases resulting.	Because as preposition
, IT'S CREATING GREENHOUSE GASES.	Meat industry produces greenhouse gases and/or uses water - general
it's producing too much pollution.	Meat industry harms environment/uses resources w/o mentioning greenhouse gases or water
it's production and transportation are creating 1/5 of the earth's harmful greenhouse gasses.	Meat industry produces greenhouse gases and/or uses water - specific numbers
it's responsible for a large portion of the earth's greenhouse gases.	Meat industry produces greenhouse gases and/or uses water - general
it's the cause of one-fifth of the earth's greenhouse gases.	Meat industry produces greenhouse gases and/or uses water - specific numbers
Growing cow to selling butchered meat now we are exporting our meats is bad carbon footprint.	Meat industry harms environment/uses resources w/o mentioning greenhouse gases or water
supports to claim	Insufficient or unintelligible response
it takes  a lot of land to raise that amount of animals to support the demand.	Meat industry harms environment/uses resources w/o mentioning greenhouse gases or water
it takes a lot of resources such as water and land to raise livestock.	Meat industry produces greenhouse gases and/or uses water - general
it takes a lot of water to raise animals for consumption.	Meat industry produces greenhouse gases and/or uses water - general
livestock and transporting meat accounts for 20% of all greenhouse gas emissions as well as half of the water consumption.	Meat industry produces greenhouse gases and/or uses water - specific numbers
the cost of transporting the meats causes 1/5 of greenhouse gasses.	Meat industry produces greenhouse gases and/or uses water - specific numbers
the cost of transporting these meat products.	Meat industry harms environment/uses resources w/o mentioning greenhouse gases or water
the efforts from transporting and raising the meats create one fifth of greenhouse gases.	Meat industry produces greenhouse gases and/or uses water - specific numbers
the raising of animals and transporting meat creates almost one-fifth of the earth’s greenhouse gases.	Meat industry produces greenhouse gases and/or uses water - specific numbers
the raising of livestock along with transporting meat creates almost 1/5 of the earth’s greenhouse gases.	Meat industry produces greenhouse gases and/or uses water - specific numbers
transporting and keeping livestock results in one fifth of the greenhouse gas.	Meat industry produces greenhouse gases and/or uses water - specific numbers
transporting and raising creates almost one-fifth of the earth’s greenhouse gases.	Meat industry produces greenhouse gases and/or uses water - specific numbers
transporting and raising livestock are creating a lot of greenhouse gases	Meat industry produces greenhouse gases and/or uses water - general
transporting and raising livestock produces more greenhouses gases than cars, trucks, and airplanes put together.	Meat industry produces greenhouse gases and/or uses water - specific numbers
transporting and raising the animals causes greenhouse gases.	Meat industry produces greenhouse gases and/or uses water - general
transporting animals cause greenhouse emissions to harm the air.	Meat industry produces greenhouse gases and/or uses water - general
transporting animals creates one fifth of greenhouse gases.	Meat industry produces greenhouse gases and/or uses water - specific numbers
transporting meat alone creates one fifth of the greenhouse gases on our planet.	Meat industry produces greenhouse gases and/or uses water - specific numbers
transporting meat and raising the animals  creates almost one-fifth of greenhouse gases.	Meat industry produces greenhouse gases and/or uses water - specific numbers
transporting meat causes a lot of greenhouse gases	Meat industry produces greenhouse gases and/or uses water - general
transporting meat create one-fifth of  earth greenhouse gases.	Meat industry produces greenhouse gases and/or uses water - specific numbers
transporting meat creates  one fifth of  the earths greenhouse gases.	Meat industry produces greenhouse gases and/or uses water - specific numbers
transporting meat creates almost one-fifth of the earth's greenhouse gases	Plagiarism
transporting meat creates almost one-fifth of the earth's greenhouse gases.	Plagiarism
transporting meat creates almost one-fifth of the earth's greenhouse gases.	Plagiarism
transporting meat creates almost one-fifth of the earth's greenhouse gasses.	Plagiarism
transporting meat creates almost one-fifth of the earth’s greenhouse gases	Plagiarism
transporting meat creates almost one-fifth of the earth’s greenhouse gases.	Plagiarism
transporting meat creates almost one-fifthof the earth’s greenhouse gases	Plagiarism
transporting meat creates around one-fifth of the worlds greenhouse gases.	Meat industry produces greenhouse gases and/or uses water - specific numbers
transporting meat creates one-fifth of the earth's greenhouse gases and livestock consume almost half of the water in the US.	Plagiarism
transporting meat creates one-fifth of the earth's greenhouse gases.	Meat industry produces greenhouse gases and/or uses water - specific numbers
transporting meat is causing an increase in greenhouse gases.	Meat industry produces greenhouse gases and/or uses water - general
transporting meat produces 1/5 of the earth's greenhouse gases and almost 1/2 of water usage in the US is dedicated to raising livestock.	Meat industry produces greenhouse gases and/or uses water - specific numbers
transporting meats accounts for one fifth of the earth's greenhouse gasses.	Meat industry produces greenhouse gases and/or uses water - specific numbers
transporting the meat across country is creating 20% of the earth's green house gases.	Meat industry produces greenhouse gases and/or uses water - specific numbers
transporting the meat causes the use of a lot of energy and pollution.	Meat industry harms environment/uses resources w/o mentioning greenhouse gases or water
transporting the meat crates alot of greenhouse gasses.	Meat industry produces greenhouse gases and/or uses water - general
transporting the meat increases greenhouse gases.	Meat industry produces greenhouse gases and/or uses water - general
transporting the meat produces pollution and raising the livestock requires large amounts of water.	Meat industry produces greenhouse gases and/or uses water - general
transporting the meat to be consumed causes large amounts of greenhouse gases.	Meat industry produces greenhouse gases and/or uses water - general
transporting the meat uses more greenhouse gases than cars.	Meat industry produces greenhouse gases and/or uses water - specific numbers
transporting this meat and raising these animals  creates almost one-fifth of the earths greenhouse gases.	Meat industry produces greenhouse gases and/or uses water - specific numbers
20% of the fuel used worldwide is used to produce and transport  meat.	Meat industry produces greenhouse gases and/or uses water - specific numbers
about half the amount of water used goes to take care of livestock.	Meat industry produces greenhouse gases and/or uses water - specific numbers
almost half of the water used in the U.S goes to raising livestock.	Plagiarism
almost half of the water used in the U.S. goes to raising livestock	Plagiarism
almost half of the water used in the U.S. goes to raising livestock.	Plagiarism
almost of the water used in the u.s. goes to raising livestock and raising animals and transporting meat creates almost one-fifth of the earth's greenhouse gases.	Plagiarism
half of the water used in the U.S. goes to raising livestock.	Plagiarism
of all raw materials and fossil fuels used in the U.S., more than one-third are devoted to raising animals for food.	Because as preposition
of all the greenhouse gases used to raise animals and transport meats.	Because as preposition
of the amount of greenhouse gases used to raise and transport the animals used for meat.	Because as preposition
of the amount of water used to raise livestock and the carbon impact of transporting meat products.	Because as preposition
of the green house gases used to transport meat.	Because as preposition
of the greenhouse gases used to transport the meat.	Because as preposition
of the large amount of water used  and greenhouse gases emitted by livestock.	Because as preposition
of the large amount of water used in raising animals on farms for meat and the amount of greenhouse gases produced.	Because as preposition
over half of the water used in the United States goes to raising animals for slaughter and one fifth of the earths green house gasses are created by raised animals.	Meat industry produces greenhouse gases and/or uses water - specific numbers
the natural resources used to raise and transport livestock is increasing.	Meat industry harms environment/uses resources w/o mentioning greenhouse gases or water
the resources used to raise and distribute meat contributes significantly to climate change.	Meat industry harms environment/uses resources w/o mentioning greenhouse gases or water
all of the transportation dramatically increases greenhouse gases.	Meat industry produces greenhouse gases and/or uses water - general
animals emit gases.	Meat industry harms environment/uses resources w/o mentioning greenhouse gases or water
animals love it when they get murdered.	Outside of article's scope
animals produce 1/5th of the earth's greenhouse gases	Meat industry produces greenhouse gases and/or uses water - specific numbers
of the production of beef domestically which creates one-fifth of the earth's greenhouse gases in raising the animals and transporting the meat crates.	Because as preposition
of the tremendous amount of greenhouse gases created by raising the animals used for meat.	Because as preposition
of the greenhouse gases produced by animal farming.	Because as preposition
of greenhouse gases produced by cars, trucks, trains, and airplanes combined.	Because as preposition
of the creation of green-house gasses caused by livestock.	Because as preposition
of the greenhouse gases caused by raising and shipping the animals/meat.	Because as preposition
the greenhouse gases caused by raising and transporting animals that will be consumed as meat are greater than that of all cars, trucks, trains, and airplanes combined.	Meat industry produces greenhouse gases and/or uses water - specific numbers
of the enormous amount of greenhouse gases produced by raising and transporting cattles	Because as preposition
the of the large quantity of greenhouse gases emitted by the animals and the transportation of them, also the amount of water used for livestock takes about half of the total American supply.	Because as preposition
of the green house gases produced by the corporations that are raising the massive amount of livestock used to feed the meat eating population.	Because as preposition
of the large quantity of greenhouse gasses emitted by  the raising and transportation of animals and meat.	Because as preposition
of the greenhouse gases produced by the raising of animals and transporting the meat.	Because as preposition
continued demand puts an enormous strain on the environment, roughly 20% of greenhouse gasses produced comes from the meat industry	Meat industry produces greenhouse gases and/or uses water - specific numbers
of the taxes emitted from the greenhouses	Because as preposition
global warming   Moderation is the key to healthy balance	Meat industry harms environment/uses resources w/o mentioning greenhouse gases or water
of greenhouse gasses produce in the production of meat (livestock).	Meat industry produces greenhouse gases and/or uses water - general
it creates more incentive to raise animals which also increases Earth's greenhouse gases.	Meat industry produces greenhouse gases and/or uses water - general
it takes up resources that would otherwise be beneficial for us to sustain and not waste.	Meat industry harms environment/uses resources w/o mentioning greenhouse gases or water
its greenhouse gases take up one fifth of the earths green house gases thats more then the gases produced by cars trucks trains and planes.	Meat industry produces greenhouse gases and/or uses water - specific numbers
its production creates greenhouse gases.	Meat industry produces greenhouse gases and/or uses water - general
its rearing and transportation causes greenhouse gases.	Meat industry produces greenhouse gases and/or uses water - general
transporting it creates one-fifth  of the earth's greenhouse gases.	Meat industry produces greenhouse gases and/or uses water - specific numbers
of supply and demand, currently in order to raise and transport meat equates to one-fifth of the earth's greenhouse gases, if we continue to support and consume meat, the industry will continue to grow and will account for an even higher amount of harmful greenhouse gases.	Meat industry produces greenhouse gases and/or uses water - specific numbers
they account for 1/5 of greenhouse gasses	Meat industry produces greenhouse gases and/or uses water - specific numbers
they account for one fifth of all greenhouse gases.	Meat industry produces greenhouse gases and/or uses water - specific numbers
they attribute to one-fifth of all of the greenhouse gases on earth.	Meat industry produces greenhouse gases and/or uses water - specific numbers
They cause greenhouse gases.	Meat industry produces greenhouse gases and/or uses water - general
they cause one fifth of the earth's greenhouse gases.	Meat industry produces greenhouse gases and/or uses water - specific numbers
they comprise one-fifth of the Earth's greenhouse gases.	Meat industry produces greenhouse gases and/or uses water - specific numbers
consume too much meat, which we produce unsustainably.	Meat industry harms environment/uses resources w/o mentioning greenhouse gases or water
they contribute 1/5 of all greenhouse gases, causing a great deal of global warming.	Meat industry produces greenhouse gases and/or uses water - specific numbers
they contribute greatly to greenhouse gas levels.	Meat industry produces greenhouse gases and/or uses water - general
they contribute significantly to greenhouse gas production.	Meat industry produces greenhouse gases and/or uses water - general
they contribute to 1/5 of the Earth's greenhouse gases, and livestock use almost half of the world's water supply.	Meat industry produces greenhouse gases and/or uses water - specific numbers
they contribute to greenhouse gases.	Meat industry produces greenhouse gases and/or uses water - general
they contribute to higher greenhouse gases and water consumption.	Meat industry produces greenhouse gases and/or uses water - general
they contribute to large amounts of greenhouse gases	Meat industry produces greenhouse gases and/or uses water - general
contributes to approximatley 1/5th of the earths greenhouse gasses.	Meat industry produces greenhouse gases and/or uses water - specific numbers
they create a large number of greenhouse gases.	Meat industry produces greenhouse gases and/or uses water - general
they create almost one fifth of the earth's greenhouse gasses.	Plagiarism
they create almost one-fifth of the earth's greenhouse gases.	Plagiarism
they create almost one-fifth of the Earth's greenhouse gases.	Plagiarism
they create greenhouse gases.	Meat industry produces greenhouse gases and/or uses water - general
they create greenhouse gasses and use a lot of water.	Meat industry produces greenhouse gases and/or uses water - general
they create greenhouses gases.	Meat industry produces greenhouse gases and/or uses water - general
they create one-fifth of the earth's greenhouse gases and use almost half of the water in the U.S.	Meat industry produces greenhouse gases and/or uses water - specific numbers
creates almost one-fifth of the earth’s greenhouse gases	Plagiarism
creates greenhouse gases.	Meat industry produces greenhouse gases and/or uses water - general
of transportation of the meat creates one fifth of the greenhouse gases that harm the earth and also livestock consume large quantities of water.	Meat industry produces greenhouse gases and/or uses water - specific numbers
could damage an important domestic industry	Irrelevant fact from article
of the greenhouse gases they emit.	Because as preposition
they emit more greenhouse gases than all means of transportation.	Meat industry produces greenhouse gases and/or uses water - specific numbers
they emit more than one fifth of overall greenhouse gases	Meat industry produces greenhouse gases and/or uses water - specific numbers
they generate more greenhouse gasses than cars, trucks, trains, and airplanes combined.	Meat industry produces greenhouse gases and/or uses water - specific numbers
they generate one fifth of greenhouse gases.	Meat industry produces greenhouse gases and/or uses water - specific numbers
they generate one-fifth of the world's greenhouse gases.	Meat industry produces greenhouse gases and/or uses water - specific numbers
they increase greenhouse emission	Meat industry produces greenhouse gases and/or uses water - general
they increase overall greenhouse gases on earth.	Meat industry produces greenhouse gases and/or uses water - general
they increase the amount of green house gas through there transportation and irrigation cost.	Meat industry produces greenhouse gases and/or uses water - general
they increase the amount of greenhouse emissions.	Meat industry produces greenhouse gases and/or uses water - general
they make up most of the greenhouse gases	Meat industry produces greenhouse gases and/or uses water - general
of the greenhouse gases they produce.	Because as preposition
of the large amounts of greenhouse gasses they produce, as well as the large amount of water it requires to raise the animals.	Because as preposition
they currently produce one-fifth of the world's greenhouse gases.	Meat industry produces greenhouse gases and/or uses water - specific numbers
they produce 1/5 of the earth's greenhouse gases.	Meat industry produces greenhouse gases and/or uses water - specific numbers
they produce a large amount of  greenhouse gas.	Meat industry produces greenhouse gases and/or uses water - general
they produce almost one fifth of the earth's green house gases.	Meat industry produces greenhouse gases and/or uses water - specific numbers
they produce almost one-fifth of greenhouse gases, as well as consuming almost half of all water used in the US.	Meat industry produces greenhouse gases and/or uses water - specific numbers
they produce almost one-fifth of the planet's greenhouse gases.	Meat industry produces greenhouse gases and/or uses water - specific numbers
they produce far too many green house gases.	Meat industry produces greenhouse gases and/or uses water - general
they produce more greenhouse gases than all automobiles combined.	Meat industry produces greenhouse gases and/or uses water - specific numbers
they produce more greenhouse gases than cars, trucks, trains, and airplanes combined.	Meat industry produces greenhouse gases and/or uses water - specific numbers
produced more greenhouse gases.	Meat industry produces greenhouse gases and/or uses water - general
producing and shipping meat products create a huge amount of greenhouse gases.	Meat industry produces greenhouse gases and/or uses water - general
they take large amount of natural resources to take care of a raise, From the land they feed of of to the water that hydrate them	Meat industry produces greenhouse gases and/or uses water - general
animals and transporting meat creates almost one-fifth of the earth’s greenhouse gases.	Meat industry produces greenhouse gases and/or uses water - specific numbers
they use a lot of water and create a lot of greenhouse gases.	Meat industry produces greenhouse gases and/or uses water - general
they use a significant amount of finite resources such as cropland and water supplies.	Meat industry produces greenhouse gases and/or uses water - general
they use a tremendous amount of energy and resources.	Meat industry harms environment/uses resources w/o mentioning greenhouse gases or water
large farms creates the most greenhouse gases.	Meat industry produces greenhouse gases and/or uses water - general
livestock wastes water and contributes to greenhouse gases.	Meat industry produces greenhouse gases and/or uses water - general
livestock production uses a lot of water, and fuel to transport them.	Meat industry produces greenhouse gases and/or uses water - general
livestock production and transportation generates a significant amount of greenhouse gases.	Meat industry produces greenhouse gases and/or uses water - general
livestock raising creates nearly one fifth of the greenhouse gases.	Meat industry produces greenhouse gases and/or uses water - specific numbers
livestock use almost have the water in the USA.	Meat industry produces greenhouse gases and/or uses water - specific numbers
meat creates almost one-fifth of the earth's greenhouse gases.	Plagiarism
meat creates almost one-fifth of the earth’s greenhouse gases	Plagiarism
meat creates almost one-fifth of the earth’s greenhouse gases.	Plagiarism
meat producn produces large amounts of greenhouse gas.	Meat industry produces greenhouse gases and/or uses water - general
meat production causes lots of emissions.	Meat industry produces greenhouse gases and/or uses water - general
meat production creates 0ne-fifth of the earth's greenhouse gases.	Plagiarism
meat production creates 20% of the earth's greenhouse gases.	Meat industry produces greenhouse gases and/or uses water - specific numbers
meat production creates a ton of greenhouse gas emissions.	Meat industry produces greenhouse gases and/or uses water - general
meat production creates huge amounts of greenhouse gases.	Meat industry produces greenhouse gases and/or uses water - general
meat production creates more greenhouse gases than motor vehicles, trains  and aircraft combined.	Meat industry produces greenhouse gases and/or uses water - specific numbers
meat production creates nearly twenty-five percent of greenhouse gases in our planet's atmosphere.	Meat industry produces greenhouse gases and/or uses water - specific numbers
meat production produces greenhouse gases.	Meat industry produces greenhouse gases and/or uses water - general
meat production produces more green house gas than all types of vehicles combimed it	Meat industry produces greenhouse gases and/or uses water - specific numbers
meat production releases emissions into the atmosphere and uses precious water resources.	Meat industry produces greenhouse gases and/or uses water - general
meat production and transport cause a fifth of greenhouse gas emissions.	Meat industry produces greenhouse gases and/or uses water - specific numbers
people enjoy eating meat, they like the taste of it.	Meat industry is actually positive
production creates 1/5 of the greenhouse gases  and requires 1/2 of the water used in the U.S.	Meat industry produces greenhouse gases and/or uses water - specific numbers
production and transport require too much water and produce excessive greenhouse gases.	Meat industry produces greenhouse gases and/or uses water - general
production and transportation produces greenhouse gasses and uses tons of water.	Meat industry produces greenhouse gases and/or uses water - general
production and transportation of meat creates greenhouse gases in excess of nearly all other sources.	Meat industry produces greenhouse gases and/or uses water - general
production of meat create a lot of green houses gases	Meat industry produces greenhouse gases and/or uses water - general
production of meat produces huge amounts of greenhouse gasses	Meat industry produces greenhouse gases and/or uses water - general
production of meat and transportation of it produces one fifth of the earths greenhouse gases.	Meat industry produces greenhouse gases and/or uses water - specific numbers
that industry pollutes the environment.	Meat industry harms environment/uses resources w/o mentioning greenhouse gases or water
the animals produce a  large amount of greenhouse gases	Meat industry produces greenhouse gases and/or uses water - general
the animals and their means of transport create more greenhouse gases than all modes of transportation combined.	Meat industry produces greenhouse gases and/or uses water - specific numbers
of the greenhouse effect the animals cause.	Meat industry produces greenhouse gases and/or uses water - general
the emissions from animals and production/distribution create large amounts of greenhouse gases	Meat industry produces greenhouse gases and/or uses water - general
the entire industry creates almost one fifth of all of the earth's greenhouse gases.	Meat industry produces greenhouse gases and/or uses water - specific numbers
it accounts for 1/5 of the greenhouse gases emitted on Earth.	Meat industry produces greenhouse gases and/or uses water - specific numbers
it adds to the overall effect of greenhouse gases.	Meat industry produces greenhouse gases and/or uses water - general
it adds to the problem of greenhouse gases and water consumption in the environment.	Meat industry produces greenhouse gases and/or uses water - general
it affects the environment.	Meat industry harms environment/uses resources w/o mentioning greenhouse gases or water
its affects the life cycle of nature.	Meat industry harms environment/uses resources w/o mentioning greenhouse gases or water
it aides in the creation of one-fifth of the earths greenhouse gases.	Meat industry produces greenhouse gases and/or uses water - specific numbers
it causes 1/5 of the earth's greenhouse gases	Meat industry produces greenhouse gases and/or uses water - specific numbers
it causes a significant amount of our pollution and wastes large amounts of water.	Meat industry produces greenhouse gases and/or uses water - general
It causes almost one-fifth of Greenhouse  gases.	Meat industry produces greenhouse gases and/or uses water - specific numbers
it causes more greenhouse gas than cars, trucks, trains, and airplanes combined.	Meat industry produces greenhouse gases and/or uses water - specific numbers
it causes one-fifth of the earth's greenhouse gases.	Meat industry produces greenhouse gases and/or uses water - specific numbers
it causes the meat Industry to boom which in turn produces more greenhouse gases.	Meat industry produces greenhouse gases and/or uses water - general
its causing greenhouse gases.	Meat industry produces greenhouse gases and/or uses water - general
it contributes to earth's greenhouse gases.	Meat industry produces greenhouse gases and/or uses water - general
it contributes to greenhouse gases.	Meat industry produces greenhouse gases and/or uses water - general
it contributes to greenhouse gasses	Meat industry produces greenhouse gases and/or uses water - general
it contributes to one fifth of greenhouse gases.	Meat industry produces greenhouse gases and/or uses water - specific numbers
it contributes to one fifth of the Earth's greenhouse gases.	Meat industry produces greenhouse gases and/or uses water - specific numbers
It contributes to one fifth of the worlds greenhouse gas emissions.	Meat industry produces greenhouse gases and/or uses water - specific numbers
it contributes to one-fifth of greenhouse gas.	Meat industry produces greenhouse gases and/or uses water - specific numbers
it contributes to the creation of 1/5 of the Earth's greenhouse gases.	Meat industry produces greenhouse gases and/or uses water - specific numbers
it contributes to the largest portion of harmful environmental greenhouse gases.	Meat industry produces greenhouse gases and/or uses water - general
it creates 1/5 of greenhouse gases which is also produced by vehicles.	Meat industry produces greenhouse gases and/or uses water - specific numbers
it creates 1/5 of the earths greenhouse gases.	Meat industry produces greenhouse gases and/or uses water - specific numbers
it creates 1/5 of the earths greenhouse gasses	Meat industry produces greenhouse gases and/or uses water - specific numbers
it creates 1/5 of the greenhouse emissions and half of the US water is used on raising  livestock.	Meat industry produces greenhouse gases and/or uses water - specific numbers
it creates 1/5 of the world's greenhouse gasses.	Meat industry produces greenhouse gases and/or uses water - specific numbers
it creates 1/5th of the green house gases.	Meat industry produces greenhouse gases and/or uses water - specific numbers
it creates a fifth of the earth's greenhouse gases.	Meat industry produces greenhouse gases and/or uses water - specific numbers
it creates a high level of greenhouse gases due to the process of raising and transporting the animals.	Meat industry produces greenhouse gases and/or uses water - general
it creates a large amount of greenhouse gases, and also uses a large amount of water to raise the animals.	Meat industry produces greenhouse gases and/or uses water - general
it creates a large carbon footprint, accounting for 1/5th of greenhouse gasses	Meat industry produces greenhouse gases and/or uses water - specific numbers
it creates a lot of greenhouse gas to produce and ship the meat.	Meat industry produces greenhouse gases and/or uses water - general
it creates almost 1/5 of the earth's greenhouse gases which is more than the gases produced by cars, trucks, trains, and airplanes combined.	Plagiarism
it creates almost 1/5 of the earths green house gases.	Plagiarism
it creates almost one fifth of the earth's greenhouse gases.	Plagiarism
it creates almost one fifth of the earths greenhouse gases.	Plagiarism
it creates almost one-fifth of the earth's greenhouse gases	Plagiarism
it creates almost one-fifth of the Earth's greenhouse gases.	Plagiarism
it creates almost one-fifth of the earth's greenhouse gases.	Plagiarism
it creates almost one-fifth of the earth’s greenhouse gases	Plagiarism
it creates almost one-fifth of the earth’s greenhouse gases, which is more than the greenhouse gases produced by cars, trucks, trains, and airplanes combined.	Plagiarism
it creates almost one-fifth of the earth’s greenhouse gases.	Plagiarism
it creates greenhouse gases and uses a lot of water resources.	Meat industry produces greenhouse gases and/or uses water - general
it creates greenhouse gases to raise and transport the animals.	Meat industry produces greenhouse gases and/or uses water - general
it creates greenhouse gases.	Meat industry produces greenhouse gases and/or uses water - general
it creates greenhouse gasses.	Meat industry produces greenhouse gases and/or uses water - general
it creates increased greenhouse gases	Meat industry produces greenhouse gases and/or uses water - general
it creates large amounts of greenhouse gases	Meat industry produces greenhouse gases and/or uses water - general
it creates large amounts of greenhouse gases.	Meat industry produces greenhouse gases and/or uses water - general
it creates more greenhouse gases than those created by cars, trucks, trains, and airplanes combined.	Meat industry produces greenhouse gases and/or uses water - specific numbers
it creates one fifth of earth's greenhouse gases.	Meat industry produces greenhouse gases and/or uses water - specific numbers
it creates one fifth of earths greenhouse gases	Meat industry produces greenhouse gases and/or uses water - specific numbers
it creates one fifth of the earth's greenhouse gases.	Meat industry produces greenhouse gases and/or uses water - specific numbers
it creates one fifth of the earth’s greenhouse gases	Meat industry produces greenhouse gases and/or uses water - specific numbers
it creates one fifth of the world's greenhouse gases.	Meat industry produces greenhouse gases and/or uses water - specific numbers
it creates one fifth of the world's greenhouse gasses.	Meat industry produces greenhouse gases and/or uses water - specific numbers
it creates one-fifth of all the earth's greenhouse gasses.	Meat industry produces greenhouse gases and/or uses water - specific numbers
it creates one-fifth of the Earth greenhouse gases.	Meat industry produces greenhouse gases and/or uses water - specific numbers
it creates one-fifth of the earth's greenhouse gases.	Meat industry produces greenhouse gases and/or uses water - specific numbers
it creates one-fifth of the greenhouse effect	Meat industry produces greenhouse gases and/or uses water - specific numbers
it creates the earth's greenhouse gases.	Meat industry produces greenhouse gases and/or uses water - general
of the gases it creates.	Meat industry produces greenhouse gases and/or uses water - general
of the greenhoouse gases it creates.	Meat industry produces greenhouse gases and/or uses water - general
of the large amount of greenhouse gasses it creates.	Meat industry produces greenhouse gases and/or uses water - general
it may creates almost 1/5th of the earth's greenhouse gases.	Plagiarism
it can damage industry,which produce as much gas as cars,trucks, trains, airplanes combine.	Insufficient or unintelligible response
it can eliminate one fifth on the greenhouse gas	Meat industry produces greenhouse gases and/or uses water - specific numbers
it generates a lot of greenhouse gas.	Meat industry produces greenhouse gases and/or uses water - general
it generates greenhouse gases.	Meat industry produces greenhouse gases and/or uses water - general
it has a huge impact on our nature	Meat industry harms environment/uses resources w/o mentioning greenhouse gases or water
it has large amounts of greenhouse gases.	Meat industry produces greenhouse gases and/or uses water - general
it could hurt the economy.	Irrelevant fact from article
it hurts the economy and takes away jobs.	Irrelevant fact from article
it increase green house gases.	Meat industry produces greenhouse gases and/or uses water - general
it increases greenhouse gas and water consumption.	Meat industry produces greenhouse gases and/or uses water - general
it increases greenhouse gas emissions.	Meat industry produces greenhouse gases and/or uses water - general
it increases greenhouse gases more than cars, trucks, trains, and airplanes combined.	Meat industry produces greenhouse gases and/or uses water - specific numbers
it increases greenhouse gases.	Meat industry produces greenhouse gases and/or uses water - general
it increases greenhouse gasses.	Meat industry produces greenhouse gases and/or uses water - general
it increases the amount of greenhouse gases present in the atmosphere	Meat industry produces greenhouse gases and/or uses water - general
it increases the amount of greenhouse gasses.	Meat industry produces greenhouse gases and/or uses water - general
it increases the earth's greenhouse gases.	Meat industry produces greenhouse gases and/or uses water - general
it increases the formation of greenhouse gases.	Meat industry produces greenhouse gases and/or uses water - general
it increases the greenhouse gases in the atmosphere.	Meat industry produces greenhouse gases and/or uses water - general
it makes the meat less and less	Insufficient or unintelligible response
it pollutes our country.	Meat industry harms environment/uses resources w/o mentioning greenhouse gases or water
it produces a large amount of greenhouse gas and water.	Meat industry produces greenhouse gases and/or uses water - general
it produces a lot of green house gases.	Meat industry produces greenhouse gases and/or uses water - general
it produces a lot of greenhouse gases.	Meat industry produces greenhouse gases and/or uses water - general
it produces a staggering amount of greenhouse gases.	Meat industry produces greenhouse gases and/or uses water - general
it produces about one fifth of the greenhouse gases in the earth.	Meat industry produces greenhouse gases and/or uses water - specific numbers
it produces excess greenhouse gases that the earth cannot handle.	Meat industry produces greenhouse gases and/or uses water - general
it produces gases	Meat industry produces greenhouse gases and/or uses water - general
it produces green house gases that are bad for the environment.	Meat industry produces greenhouse gases and/or uses water - general
it produces greenhouse gases.	Meat industry produces greenhouse gases and/or uses water - general
it produces large amounts of greenhouse gasses.	Meat industry produces greenhouse gases and/or uses water - general
it produces more green house gases from the delivery trucks.	Meat industry produces greenhouse gases and/or uses water - general
it produces more green house gasses than transportation does.	Meat industry produces greenhouse gases and/or uses water - specific numbers
it produces more greenhouse gases than all machinery ran on gasoline combined.	Meat industry produces greenhouse gases and/or uses water - specific numbers
it produces more greenhouse gases than cars, planes, and trains all together; one fifth in total.	Meat industry produces greenhouse gases and/or uses water - specific numbers
of green house gases it produces .	Meat industry produces greenhouse gases and/or uses water - general
of the raising and transportation of meat and the gases it produces	Meat industry produces greenhouse gases and/or uses water - general
it raises greenhouse gasses.	Meat industry produces greenhouse gases and/or uses water - general
it raises levels of greenhouse gases.	Meat industry produces greenhouse gases and/or uses water - general
it raising and transporting meat is responsible for almost one-fifth of the earth’s greenhouse gases	Meat industry produces greenhouse gases and/or uses water - specific numbers
its raising meat is creating a lot of greenhouse gases, and using a lot of water.	Meat industry produces greenhouse gases and/or uses water - general
it release a lot of greenhouse gases into the atmosphere.	Meat industry produces greenhouse gases and/or uses water - general
it requires a lot of resources contributing to 20% of green house gases generated by man.	Meat industry produces greenhouse gases and/or uses water - specific numbers
it requires a lot of water to grow cattle and transporting the meat releases a lot of greenhouse gases.	Meat industry produces greenhouse gases and/or uses water - general
it does not say	Outside of article's scope
it could take away jobs.	Irrelevant fact from article
it takes one fifth of the earth's greenhouse gases.	Meat industry produces greenhouse gases and/or uses water - specific numbers
it used a lot of greenhouse gases and a lot of water.	Meat industry produces greenhouse gases and/or uses water - general
it uses  a lot of water	Meat industry produces greenhouse gases and/or uses water - general
it uses a lot of gases, more than what it takes to use cars.	Meat industry produces greenhouse gases and/or uses water - general
it uses a lot of water and contributes a lot of greenhouse gases.	Meat industry produces greenhouse gases and/or uses water - general
it uses an enormous amount of water, and produces 1/5th of the Earth's greenhouse gas emissions.	Meat industry produces greenhouse gases and/or uses water - specific numbers
it uses extremely large amounts of greenhouse gases.	Meat industry produces greenhouse gases and/or uses water - general
it uses half of our water and produces a great deal of Greenhouse gases.	Meat industry produces greenhouse gases and/or uses water - specific numbers
it uses up the earth's greenhouse gases.	Meat industry produces greenhouse gases and/or uses water - general
it uses up too much of the earth's water sources and creates too much greenhouse gas especially compared to other industries.	Meat industry produces greenhouse gases and/or uses water - general
the cause one fifth of the greenhouse gases to get them from farm to fork.	Meat industry produces greenhouse gases and/or uses water - specific numbers
of the greenhouse gases preparing and transporting meat creates.	Because as preposition
the greenhouse gases, which may contribute to global warming, given off by the livestock raised in the United States exceeds that produced by cars, trucks, trains and airplanes.	Meat industry produces greenhouse gases and/or uses water - general
transportation for those meats causes 1/5 of the greenhouse gasses harming the earth right now.	Meat industry produces greenhouse gases and/or uses water - specific numbers
the industry creates a large amount of green  house gases.	Meat industry produces greenhouse gases and/or uses water - general
the industry creates nearly 1/5 of earth's greenhouse gases and consumes about half of the water used.	Meat industry produces greenhouse gases and/or uses water - specific numbers
the livestock industry accounts for almost one-fifth of the earth's greenhouse gases.	Meat industry produces greenhouse gases and/or uses water - specific numbers
of the animals and transportation of the meat creates about 1/5th of the earth's greenhouse gases	Meat industry produces greenhouse gases and/or uses water - specific numbers
the meat industry causes almost one-fifth of the  greenhouse gases in the environment.	Meat industry produces greenhouse gases and/or uses water - specific numbers
the meat industry causes large emissions of greenhouse gases.	Meat industry produces greenhouse gases and/or uses water - general
the meat industry contributes one fifth of the worlds greenhouse gasses.	Meat industry produces greenhouse gases and/or uses water - specific numbers
the meat industry  creates almost one-fifth of the earth’s greenhouse gases.	Meat industry produces greenhouse gases and/or uses water - specific numbers
the meat industry creates a huge portion of greenhouse gases.	Meat industry produces greenhouse gases and/or uses water - specific numbers
the meat industry creates almost one fifth of all greenhouse gas emissions	Meat industry produces greenhouse gases and/or uses water - specific numbers
the meat industry creates almost one-fifth of the earth's greenhouse gases.	Meat industry produces greenhouse gases and/or uses water - specific numbers
the meat industry creates an immense amount of greenhouse gases.	Meat industry produces greenhouse gases and/or uses water - specific numbers
the meat industry creates one-fifth of greenhouse gases.	Meat industry produces greenhouse gases and/or uses water - specific numbers
the meat industry emits about one fifth of the world's pollution (greenhouse gas.)	Meat industry produces greenhouse gases and/or uses water - specific numbers
the meat industry generates a fifth of greenhouse gases and accounts for half of American water use.	Meat industry produces greenhouse gases and/or uses water - specific numbers
the meat industry generates insane amounts of greenhouse gases and consumes almost half of America's water usage.	Meat industry produces greenhouse gases and/or uses water - specific numbers
the meat industry produces 1/5 of the green house gasses.	Meat industry produces greenhouse gases and/or uses water - specific numbers
the meat industry produces 1/5 of the greenhouse gases that are harming the earth and creating climate change.	Meat industry produces greenhouse gases and/or uses water - specific numbers
the meat industry produces 1/5th of all greenhouse gases on Earth.	Meat industry produces greenhouse gases and/or uses water - specific numbers
the meat industry produces one-fifth of the greenhouse gases on earth, more than cars, trucks, trains, and planes combined.	Meat industry produces greenhouse gases and/or uses water - specific numbers
the meat industry uses a lot of energy and resources in its operations.	Meat industry produces greenhouse gases and/or uses water - general
the meat industry uses a lot of resources, like water, and emits a lot of greenhouse gases	Meat industry produces greenhouse gases and/or uses water - general
the people kill a lot of animal to satisfy the people desire.	Outside of article's scope
the process causes 1/5 of the earths green house gases	Meat industry produces greenhouse gases and/or uses water - specific numbers
the process creates nearly one-fifth of earth's greenhouse gases.	Meat industry produces greenhouse gases and/or uses water - general
the process emits large amounts of greenhouse gasses.	Meat industry produces greenhouse gases and/or uses water - general
the production and transportation of animals and meat generate one fifth of the worlds greenhouse gases.	Meat industry produces greenhouse gases and/or uses water - specific numbers
the production and transportation of meat creates a great deal of pollution, especially green house gases.	Meat industry produces greenhouse gases and/or uses water - general
the production and transportation of meat makes a lot of greenhouse gas.	Meat industry produces greenhouse gases and/or uses water - general
the production and transportation of meat products uses large amounts of natural resources.	Meat industry produces greenhouse gases and/or uses water - general
the production of meat causes greenhouse gasses.	Meat industry produces greenhouse gases and/or uses water - general
the production of meat contributes more greenhouse gases than the combined greenhouse gases of cars, trucks, and airplanes combined.	Meat industry produces greenhouse gases and/or uses water - general
the production of meat creates large amount of greenhouse gases.	Meat industry produces greenhouse gases and/or uses water - general
the production of meat produces large amounts of greenhouse gases, causing climate change.	Meat industry produces greenhouse gases and/or uses water - general
the production of meat products causes 20 % of the world's greenhouse gases - more than automobiles and trucks combined.	Meat industry produces greenhouse gases and/or uses water - specific numbers
the production of meats create greenhouse gases.	Meat industry produces greenhouse gases and/or uses water - general
the raising and transport of animals for consumption increases greenhouse gases.	Meat industry produces greenhouse gases and/or uses water - general
the raising and transport of meat creates a lot of "greenhouse gases"	Meat industry produces greenhouse gases and/or uses water - general
the raising and transportation of livestock creates 1/5 of all greenhouse gases on Earth.	Meat industry produces greenhouse gases and/or uses water - specific numbers
the raising and transportation of meat create up to one fifth of the earth's greenhouse gases.	Meat industry produces greenhouse gases and/or uses water - specific numbers
the raising and transportation of meat products creates more greenhouse gases than cars, trucks, trains and airplanes combined.	Meat industry produces greenhouse gases and/or uses water - general
the raising and transportation of the animals creates greenhouse gases.	Meat industry produces greenhouse gases and/or uses water - general
the raising of animals behind the meat, cause almost one-fifth of the earth's greenhouse gases.	Meat industry produces greenhouse gases and/or uses water - specific numbers
the raising of livestock creates a lot of greenhouse gas.	Meat industry produces greenhouse gases and/or uses water - general
the raising of the animals requires the heavy use of water - nearly 50% in the US - plus the transportation costs to move the animal from farms to processing plants to end users causes significant greenhouse gases.	Meat industry produces greenhouse gases and/or uses water - specific numbers
the raising of the animals and the transport of the meats create almost 1/5 of the earth's greenhouse gases.	Meat industry produces greenhouse gases and/or uses water - specific numbers
the raising of the animals and transporting of the meat creates almost one-fifth of the earth's greenhouse gases.	Meat industry produces greenhouse gases and/or uses water - specific numbers
the raising of these animals creates approximately one-fifth of the earth's greenhouse gasses.	Meat industry produces greenhouse gases and/or uses water - specific numbers
the raising, transportation and processing of livestock creates one-fifth of the earth's greenhouse gases.	Meat industry produces greenhouse gases and/or uses water - specific numbers
the transport and production stages of meat cause a massive amount of damage to the environment.	Meat industry harms environment/uses resources w/o mentioning greenhouse gases or water
the transport of meats make up the majority of greenhouse gases.	Meat industry produces greenhouse gases and/or uses water - general
the transportion of meat creates large amounts of greenhouse gases.	Meat industry produces greenhouse gases and/or uses water - general
their production created greenhouse gases that harm the environment.	Meat industry produces greenhouse gases and/or uses water - general
their production and transportation produce greenhouse gases.	Meat industry produces greenhouse gases and/or uses water - general
they create more than 1/5 of the earth's greenhouse gases.	Meat industry produces greenhouse gases and/or uses water - specific numbers
they emit greenhouse gasses.	Meat industry produces greenhouse gases and/or uses water - general
they kill animals	Outside of article's scope
they produce greenhouse gasses in the production process.	Meat industry produces greenhouse gases and/or uses water - general
this creates almost one fifth of the earth's greenhouse gases.	Meat industry produces greenhouse gases and/or uses water - general
it takes more than just eating it to cause problems, transportation and methane can be harmful	Meat industry harms environment/uses resources w/o mentioning greenhouse gases or water
it takes more resources to get it to the plate	Meat industry harms environment/uses resources w/o mentioning greenhouse gases or water
it takes 2,500 gallons of water to produce a pound of meat	Outside of article's scope
it takes a lot of water to provide the animals with all of the food and water they need.	Meat industry harms environment/uses resources w/o mentioning greenhouse gases or water
of the resources it takes to raise animals and transport meat.	Meat industry harms environment/uses resources w/o mentioning greenhouse gases or water
of what it takes to raise the animals and transport the meat.	Meat industry harms environment/uses resources w/o mentioning greenhouse gases or water
it not only takes a ton of water to raise them, but it creates alot of pollution as well.	Meat industry produces greenhouse gases and/or uses water - general
it takes a lot of energy to raise, process and transport animal products.	Meat industry harms environment/uses resources w/o mentioning greenhouse gases or water
it takes a lot of energy, resources, and effort to sustain the meat industry.	Meat industry harms environment/uses resources w/o mentioning greenhouse gases or water
transport and creation of meat increases greenhouse gases.	Meat industry produces greenhouse gases and/or uses water - general
transport of this creates 1/5 of Earth's greenhouse gases.	Meat industry produces greenhouse gases and/or uses water - specific numbers
transportation of animals causes pollution.	Meat industry harms environment/uses resources w/o mentioning greenhouse gases or water
the more we consume, the higher amounts of raising and transporting animal meat creates more greenhouse gases.	Meat industry produces greenhouse gases and/or uses water - general
of the transportation and upkeep of the livestock we depend on for the meat.	Because as preposition
we depend too much on meat as a main source of food.	Outside of article's scope
the rate at which we farm domestic animals creates one-fifth of Earth's greenhouse gasses, and that industry is only expanding.	Meat industry produces greenhouse gases and/or uses water - specific numbers
half of the water we have goes to raising livestock	Meat industry produces greenhouse gases and/or uses water - specific numbers
vast resources we no longer have are being spent on raising livestock.	Meat industry harms environment/uses resources w/o mentioning greenhouse gases or water
we kill too many animals	Outside of article's scope
we live in a day and age where food can be processed to imitate the properties of meat.	Outside of article's scope
among other things the generation of greenhouse gases.	Meat industry produces greenhouse gases and/or uses water - general
CC AND GREENHOUSE GASSES.	Meat industry produces greenhouse gases and/or uses water - general
cv	Insufficient or unintelligible response
dhshdhshshs	Insufficient or unintelligible response
environmental protection	Irrelevant fact from article
greenhouse gases	Meat industry produces greenhouse gases and/or uses water - general
greenhouse gases and water consumption.	Meat industry produces greenhouse gases and/or uses water - general
greenhouse gases.	Meat industry produces greenhouse gases and/or uses water - general
greenhouse gases.	Meat industry produces greenhouse gases and/or uses water - general
greenhouses gases	Meat industry produces greenhouse gases and/or uses water - general
happy	Insufficient or unintelligible response
its really good	Outside of article's scope
meat production contributes strongly to creation of greenhouse gases.	Meat industry produces greenhouse gases and/or uses water - general
meat production contributes to 1/5 of greenhouse gases.	Meat industry produces greenhouse gases and/or uses water - specific numbers
of carbon emissions.	Because as preposition
of gas emissions	Because as preposition
of gas.	Because as preposition
of green house gases.	Because as preposition
of greenhouse gas emissions	Because as preposition
of greenhouse gas emissions.	Because as preposition
of greenhouse gases	Because as preposition
of greenhouse gases	Because as preposition
of greenhouse gases and excessive water use.	Because as preposition
of greenhouse gases from transportation and animals themselves.	Because as preposition
of greenhouse gases, almost one fifth.	Because as preposition
of greenhouse gases.	Because as preposition
of greenhouse gases.	Because as preposition
of greenhouse gasses.	Because as preposition
of greenhouses gases.	Because as preposition
of increase in greenhouse gases.	Because as preposition
of the animals' greenhouse gas emissions.	Because as preposition
of the contribution to deadly greenhouse gasses in our atmosphere.	Because as preposition
of the creation of greenhouse gas.	Because as preposition
of the emissions of greenhouse gases and the use of high quantities of water.	Because as preposition
of the green house effects.	Because as preposition
of the green house gasses.	Because as preposition
of the greenhouse gases.	Because as preposition
of the increase of greenhouse gases from the transportation of meat.	Because as preposition
of the production requirements of the industry.	Because as preposition
of the the raising and transportation of feed animals across the United States and the world.	Because as preposition
of their impact on greenhouse gas emisions	Because as preposition
of transport and the use of water.	Because as preposition
of transportation harms the environment and water consumption.	Because as preposition
one fifth of earth's greenhouse gases.	Meat industry produces greenhouse gases and/or uses water - specific numbers
one-fifth of the earth’s greenhouse gases.	Meat industry produces greenhouse gases and/or uses water - specific numbers
one-fifth of the earth’s greenhouse gases.	Meat industry produces greenhouse gases and/or uses water - specific numbers
some people cling to a false climate change idea.	Outside of article's scope
the production and transportation of meats accounts for a good 20% of greenhouse gas emissions.	Meat industry produces greenhouse gases and/or uses water - specific numbers
the release of greenhouse gasses.	Meat industry produces greenhouse gases and/or uses water - general
the transportation of meat contributes to the earth's greenhouse gases.	Meat industry produces greenhouse gases and/or uses water - general
the transportation of those meats accounts for one fifth of the earth's greenhouse gases.	Meat industry produces greenhouse gases and/or uses water - specific numbers
there	Insufficient or unintelligible response
x	Insufficient or unintelligible response
