they only account for 20% of the world's total greenhouse gases, there are other factors at play that we need to start regulating in order to take care of the other 80%.	Outside of article's scope
the meat industry accounts for a large portion of jobs in the US.	Meat creates jobs and benefits economy
it adds to the protein needed for good nutrition.	Eating meat is necessary for good nutrition
many people still adopt the American tradition of meat consumption.	Eating meat is part of culture/tradition
it would affect economy and culture if all turns to vegetarian	Less meat consumption could harm economy and cut jobs
it also positively affects the economy.	Meat creates jobs and benefits economy
for people like me, a flexitarian, I need red meat and turkey to maintain my iron levels - so I am very careful to eat the healthiest possible meats.	Flexitarian w/o connection to environment or jobs
humans are literally made to eat meat.	People will or should still eat meat
are important part of the economy.	Meat creates jobs and benefits economy
people are consuming more and more meat.	People will or should still eat meat
there are options to reduce the environmental impact while still consuming meat	Flexitarians benefit environment
are a source of employment and revenue domestically.	Meat creates jobs and benefits economy
are an important domestic industry, helping maintain a strong economy.	Meat creates jobs and benefits economy
they are a part of our culture and they employ a lot of people.	Meat creates jobs and benefits economy
numbers of people are becoming flexitarians as they eat meat on occasion while continuing to be a vegetarian.	Flexitarian w/o connection to environment or jobs
there are ways to make the environment better by eliminating meat and becoming Flexitarians.	Flexitarians benefit environment
some people are choosing to eat either a plant based diet, or one that incorporates only small amounts of meat.	Flexitarian w/o connection to environment or jobs
exports are also increasing as more countries integrate meat into their daily lives.	The meat industry is important/thriving and/or exports/demand increasing
people are trying to live a healthier life by being vegan.	Flexitarian w/o connection to environment or jobs
exports are also increasing as more countries integrate meat into their daily diets.	The meat industry is important/thriving and/or exports/demand increasing
are a part of the American culture.	Eating meat is part of culture/tradition
more countries are increasing  meat into their daily lives.	The meat industry is important/thriving and/or exports/demand increasing
exports are increasing, which leads to the economy increasing and more jobs.	Meat creates jobs and benefits economy
many jobs are provided by the meat industry.	Meat creates jobs and benefits economy
from an economic position exports are thriving and also meat is quite a large part of many american's diet and tradition.	The meat industry is important/thriving and/or exports/demand increasing
we are making money off the exporting of meat to other countries.	The meat industry is important/thriving and/or exports/demand increasing
nevertheless, people are eating  a lot of meat and the meat industry is thriving.	The meat industry is important/thriving and/or exports/demand increasing
exports are increasing as a result of more countries integrating meat into their diets, and the meat industry is thriving.	The meat industry is important/thriving and/or exports/demand increasing
meat exports are occurring which stabilize and provide jobs for Americans.	Meat creates jobs and benefits economy
exports are also increasing as more countries integrate meat into their daily diets.	The meat industry is important/thriving and/or exports/demand increasing
still are essential for humans to survive.	People will or should still eat meat
animals are so tasty.	People will or should still eat meat
they are helping the economy stay strong and vibrant.	Meat creates jobs and benefits economy
some countries culture are heavily influenced by the consumption of meat	Eating meat is part of culture/tradition
people are reducing their meat consumption	Flexitarian w/o connection to environment or jobs
are supporting the economy, especially as the world incorporates more meat in their diets.	Meat creates jobs and benefits economy
people are set in their ways and don’t want to change their habits.	People will or should still eat meat
some people choose another option, "Flexitarians” are vegetarians who eat meat occasionally.	Flexitarian w/o connection to environment or jobs
exports are also increasing as more countries integrate meat intotheir daily lives.	The meat industry is important/thriving and/or exports/demand increasing
people are part of the environment and despite assertions to the contrary it is a natural part of our biological makeup to consume meat and has been for tens of thousands of years.	People will or should still eat meat
are helping the economy.	Meat creates jobs and benefits economy
they are benefiting the global economy.	Meat creates jobs and benefits economy
there are some flexitarians who use a mostly plant based diet with some fish and chicken.	Flexitarian w/o connection to environment or jobs
one fifth of the earths greenhouse gasses are created by raising domestic animals for food.	Meat consumption harms environment
there are ways to produce meat in the lab This would make meat consumption viable.	Outside of article's scope
exports are increasing as more countries integrate meat into their daily diets so the meat industry is thriving.	The meat industry is important/thriving and/or exports/demand increasing
some people are choosing the flexitarian option	Flexitarian w/o connection to environment or jobs
are an essential part of our culture and traditions.	Eating meat is part of culture/tradition
they are part of American tradition, and also create jobs.	Meat creates jobs and benefits economy
there are responsible ways of doing it.	Outside of article's scope
they are vital to the domestic economy.	Meat creates jobs and benefits economy
there are safer options.	Flexitarian w/o connection to environment or jobs
people are now turning flexitarians by consumin vegetarian diet and taking meat occasionally.	Flexitarian w/o connection to environment or jobs
if ways are changed by eating less or moderating consumption we can ease the harm.	Flexitarians benefit environment
are also beneficial to the economy because of the many jobs associated with meat production and transportation.	Meat creates jobs and benefits economy
American exports are increasing since more countries are incorporating meat into their daily diets.	The meat industry is important/thriving and/or exports/demand increasing
since other countries are starting to incorporate more meat into their diets, the meat industry is thriving and helping the American economy.	Meat creates jobs and benefits economy
some people are choosing to consume less meat.	Flexitarian w/o connection to environment or jobs
exports are increasing as many countries integrate meat into their daily diet and the meat industry is thriving.	The meat industry is important/thriving and/or exports/demand increasing
they are also helping boost our economy and keeping many people employed.	Meat creates jobs and benefits economy
they are an important part of our diet, our culture, and our economy.	Meat creates jobs and benefits economy
some people are Flexitarians who eat vegetables regularly and are occasional meat eaters	Flexitarian w/o connection to environment or jobs
many meat dishes (such as barbecue, chili, etc.) are an integral part of American culture.	Eating meat is part of culture/tradition
there are other ways to help the environment such as using more flex fuel and green in cars, truck, buses.	Outside of article's scope
there are those who are working to combat the adverse effects of the industry.	Change without mentioning consumption
there are alternatives to giving it up entirely.	Flexitarian w/o connection to environment or jobs
for Americans, meat dishes are an integral part of their culture and traditions, and the meat industry is a robust element of our economy.	Meat creates jobs and benefits economy
meat exports are increasing and creating a more profitable business.	The meat industry is important/thriving and/or exports/demand increasing
so are cars, trucks, trains, and airplanes.	Outside of article's scope
humans are getting protein.	Eating meat is necessary for good nutrition
"flexitarians” are vegetarians who eat meat occasionally.	Flexitarian w/o connection to environment or jobs
there are ways to limit the amount of meat consumption around the U.S by becoming a "flexitarian"	Flexitarian w/o connection to environment or jobs
they are also providing valuable jobs for many people as the meat export industry grows.	Meat creates jobs and benefits economy
people are finding new ways of incorporating meat into their diet, such as the flexitarians who eat meat occasionally.	Flexitarian w/o connection to environment or jobs
other countries are starting to eat more meat regardless.	People will or should still eat meat
they are part of the American way.	Eating meat is part of culture/tradition
people are making compromises by becoming occasional meat consumers, known as "flexatarians".	Flexitarians benefit environment
are an essential domestic industry.	The meat industry is important/thriving and/or exports/demand increasing
are a major domestic industry that would be damaging to loose	Less meat consumption could harm economy and cut jobs
exports are increasing.	The meat industry is important/thriving and/or exports/demand increasing
are also helping our economy.	Meat creates jobs and benefits economy
exports are increasing as more countries integrate meat into their daily diets.	The meat industry is important/thriving and/or exports/demand increasing
exports are also increasing by many countries, as they integrate meat consumption into their diets.	The meat industry is important/thriving and/or exports/demand increasing
there are more jobs when meat is consumed.	Meat creates jobs and benefits economy
are providing people jobs and could hurt the economy and those within the meat production industry.	Meat creates jobs and benefits economy
a lot of people are employed in the meat producing industry.	Meat creates jobs and benefits economy
they are an important and a symbolic part of many American's lives	Eating meat is part of culture/tradition
some people are vegetarians and only eat meat occasionally.	Flexitarian w/o connection to environment or jobs
flexitarians are people who are trying to reduce this harm by only eating meat occasionally with a primarily vegetarian diet.	Flexitarians benefit environment
exports are also increasing as more countries integrate meat into their daily diets making meat a thriving industry.	The meat industry is important/thriving and/or exports/demand increasing
are creating jobs.	Meat creates jobs and benefits economy
exports are increasing as more countries are integrating meat into their diet	The meat industry is important/thriving and/or exports/demand increasing
are icon of holidays in America such as eating hot dogs and Hamburgers on the fourth of July.	Eating meat is part of culture/tradition
Americans are used to having it in their diets.	People will or should still eat meat
Americans are unlikely to change their habits due to the integration of meat into American culture.	Eating meat is part of culture/tradition
more countries are integrating meat into their daily diets.	The meat industry is important/thriving and/or exports/demand increasing
many meats are traditional to American food and are symbolic for holidays such as Thanksgiving.	Eating meat is part of culture/tradition
other countries are increasing their meat consumption, thereby increasing demand for meat.	The meat industry is important/thriving and/or exports/demand increasing
there are ways people can combat the amount of greenhouse gases given off by transporting the animals.	Change without mentioning consumption
exports are also increasing as more countries put in meat into their diet.	The meat industry is important/thriving and/or exports/demand increasing
there are flexitarians, people who belueve that most of their diet should be plant-based, with occasional meat consumption.	Flexitarian w/o connection to environment or jobs
meat and fish are part of most healthy diets in moderation.	Flexitarian w/o connection to environment or jobs
exports of meat from the U.S. are increasing as more countries integrate meat into their diets.	The meat industry is important/thriving and/or exports/demand increasing
if we ate less meat, the meat industry would suffer.	Less meat consumption could harm economy and cut jobs
to avoid over animal population eating meat is necessary.	Outside of article's scope
it is also creating and maintaining jobs and supporting the economy.	Meat creates jobs and benefits economy
meat is an important industry in the united states, culturally and economically	The meat industry is important/thriving and/or exports/demand increasing
meat consumption is such a big part of American culture, it is likely to continue and even grow.	Meat creates jobs and benefits economy
it is contributing to jobs in America and apart of our culture.	Meat creates jobs and benefits economy
it is imported to other countries as well as consumed in the USA, which has made it an important domestic industry.	The meat industry is important/thriving and/or exports/demand increasing
the meat industry is doing an all time high amount of business.	The meat industry is important/thriving and/or exports/demand increasing
it is an important domestic industry	The meat industry is important/thriving and/or exports/demand increasing
the meat industry is thriving.	The meat industry is important/thriving and/or exports/demand increasing
the meat industry is thriving because beef produced domestically is a huge export and is helping the economy.	Meat creates jobs and benefits economy
meat is necessary for human beings to keep important traditions.	Eating meat is part of culture/tradition
moderation is ley....	Flexitarian w/o connection to environment or jobs
it is the American culture and tradition.	Eating meat is part of culture/tradition
the industry is an important  portion of the economy, producing many jobs	Meat creates jobs and benefits economy
there is something we can do to stop the harm, but also not eliminate the meat industry.	Change without mentioning consumption
the meat industry is thriving right now.	The meat industry is important/thriving and/or exports/demand increasing
it is also helping the economy due to increasing exports to an increasing number of other countries.	Meat creates jobs and benefits economy
meat is also important for our economy because it represents a large part of exports and domestic trade.	Meat creates jobs and benefits economy
the industry as a whole is thriving.	The meat industry is important/thriving and/or exports/demand increasing
the industry is growing as more countries consume and transport meat, so reducing meat intake could hurt the economy.	Less meat consumption could harm economy and cut jobs
is fueling a thriving meat industry.	The meat industry is important/thriving and/or exports/demand increasing
it is normal for people to eat meat.	People will or should still eat meat
it is helping the economy.	Meat creates jobs and benefits economy
is still needed for larger buisneses	Irrelevant facts from article
the meat industry is a thriving staple for the U.S. economy.	Meat creates jobs and benefits economy
meat is one essential component for a well-balanced meal.	Eating meat is necessary for good nutrition
it is creating jobs.	Meat creates jobs and benefits economy
the meat industry is thriving and providing jobs for a number of Americans each year.	Meat creates jobs and benefits economy
there is an option between never eating meat again and continuing at the current consumption rates.	Flexitarian w/o connection to environment or jobs
it is also very beneficial for the economy and it creates a lot of jobs by producing and exporting meat.	Meat creates jobs and benefits economy
is also giving people jobs and helping the economy.	Meat creates jobs and benefits economy
it is an American tradition to eat meat products such as hot dogs and hamburgers and it would hurt our traditions and culture.	Eating meat is part of culture/tradition
human body is health	Eating meat is necessary for good nutrition
the meat industry is still striving	The meat industry is important/thriving and/or exports/demand increasing
the meat industry is important and accounts for a large amount of jobs.	Meat creates jobs and benefits economy
the population's need is too great to be ignored.	People will or should still eat meat
the meat industry is also an important source of American jobs.	Meat creates jobs and benefits economy
their is nothing to worry about because industry adapts to demand, Avocado orchids, mushroom farms, and veganic farming are on the up and up.	Outside of article's scope
meat production is an integral part of the American economy and also exports are increasing.	Meat creates jobs and benefits economy
is good for the economy.	Meat creates jobs and benefits economy
it is a large part of tge American economy.	Meat creates jobs and benefits economy
it is an American tradition to eat meat.	Eating meat is part of culture/tradition
meat consumption in the US and abroad is a thriving industry domestically.	The meat industry is important/thriving and/or exports/demand increasing
livestock is an important industry in the U.S. and its reduction could significantly hurt the economy.	Less meat consumption could harm economy and cut jobs
the meat industry is thriving due to the demand.	The meat industry is important/thriving and/or exports/demand increasing
the meat industry is thriving, with more and more meat being exported.	The meat industry is important/thriving and/or exports/demand increasing
the meat industry is thriving and provides lots of jobs.	Meat creates jobs and benefits economy
meat is  vital and loaded with protein for our consumption	Eating meat is necessary for good nutrition
it is better to encourage more moderate meat consumption than try to ban eons old tradition of meat consumption.	Flexitarian w/o connection to environment or jobs
the meat industry is thriving and provides many jobs.	Meat creates jobs and benefits economy
the meat industry is thriving and allowing growth of the domestic industry and more importantly domestic jobs to support our own economy.	Meat creates jobs and benefits economy
the meat business is thriving	The meat industry is important/thriving and/or exports/demand increasing
it is necessary to uphold the American culture of meat consumption as well as sustaining the domestic meat industries	The meat industry is important/thriving and/or exports/demand increasing
meat production is a significant part of the U.S. economy.	Meat creates jobs and benefits economy
e meat industry is thriving	The meat industry is important/thriving and/or exports/demand increasing
the meat industry is crucial to the world's economy.	Meat creates jobs and benefits economy
at the same time meat industry is a thriving industry that boost economy by providing job opportunities	Meat creates jobs and benefits economy
the meat industry is thriving	The meat industry is important/thriving and/or exports/demand increasing
meat is a delicious part of American culture and a good source of protein.	People will or should still eat meat
is an important part of domestic economy.	Meat creates jobs and benefits economy
the meat industry is doing very well and limiting consumption could very well hurt our economy.	Less meat consumption could harm economy and cut jobs
meat is apart of American tradition.	Eating meat is part of culture/tradition
the meat industry is important economically, and some believe that responsible meat consumption is acceptable as a small part of a mostly plant-based diet.	Meat creates jobs and benefits economy
our meat industry is thriving.	The meat industry is important/thriving and/or exports/demand increasing
it is an important part of the economy	Meat creates jobs and benefits economy
is an important domestic industry that gives many jobs and helps the economy thrive.	Meat creates jobs and benefits economy
the economy is strengthened by the consumption of meat.	Meat creates jobs and benefits economy
the meat industry is thriving and reducing meat consumption could damage domestic industry	Less meat consumption could harm economy and cut jobs
it is also part of American industry and economy which means that it helps support jobs	Meat creates jobs and benefits economy
it is a thriving industry and the economy would suffer substantially with all the jobs lost if Americans no longer consumed meat.	Less meat consumption could harm economy and cut jobs
it is an important domestic industry	The meat industry is important/thriving and/or exports/demand increasing
As a result, the meat industry is thriving	The meat industry is important/thriving and/or exports/demand increasing
meat consumption is delicious and awesome.	People will or should still eat meat
meat is a healthy part of an average diet.	Eating meat is necessary for good nutrition
the industry is thriving.	The meat industry is important/thriving and/or exports/demand increasing
it is a difficult situation because stopping the meat industry would harm the economy as many parts of the world are also adopting meat into their diets.	Less meat consumption could harm economy and cut jobs
it is an important domestic industry and provides jobs.	Meat creates jobs and benefits economy
some meat is important in a healthy diet.	Eating meat is necessary for good nutrition
the meat industry is a major provider of jobs for the economy.	Meat creates jobs and benefits economy
it is an essential part of American culture and tradition.	Eating meat is part of culture/tradition
protein is essential for your diet.	Eating meat is necessary for good nutrition
what harm is actually being done.	Outside of article's scope
it is a symbolic part of the U.S. culture and traditions.	Eating meat is part of culture/tradition
many parts of USA tradition is centered around meat!	Eating meat is part of culture/tradition
meat is a traditional staple in so much of the world.	Eating meat is part of culture/tradition
there is concern that reducing meat production could harm the economy.	Less meat consumption could harm economy and cut jobs
the meat is more likely food for many  peoples	People will or should still eat meat
meat consumption is an American tradition and part of the culture.	Eating meat is part of culture/tradition
some people feel that tradition is more important than the continued health of the planet.	Eating meat is part of culture/tradition
it is also providing a ton of jobs in the domestic industry.	Meat creates jobs and benefits economy
it is only 1/5 of the total greenhouse gasses contribution.	Irrelevant facts from article
it is also boosting the economy and providing many jobs.	Meat creates jobs and benefits economy
meat is an essential part of our culture	Eating meat is part of culture/tradition
it is our right to eat what we want.	Outside of article's scope
the meat industry is thriving because of American diets and exports.	The meat industry is important/thriving and/or exports/demand increasing
in america it is the part of culture and traditions	Eating meat is part of culture/tradition
it is a part of everyday lives and tradition.	Eating meat is part of culture/tradition
it is helping Americans knowing that there is an industry for meat consumption.	Meat creates jobs and benefits economy
it is needed for an appropriate and healthy diet.	Eating meat is necessary for good nutrition
it is also helping the economics of the world due to more people consuming meat world wide.	Meat creates jobs and benefits economy
the meat industry is thriving.	The meat industry is important/thriving and/or exports/demand increasing
it is helping the economy by providing more jobs and exporting it to other countries that are starting to add meat into their daily diets.	Meat creates jobs and benefits economy
As a result, the meat industry is thriving.	The meat industry is important/thriving and/or exports/demand increasing
the meat industry is booming in America, and creating great economic growth.	Meat creates jobs and benefits economy
it is not as bad if you eat in moderation.	Flexitarians benefit environment
claims of how much damage is being done are exaggerated because climate change is a natural part of how the changes over time.	Outside of article's scope
meat is a staple in our American diets and has become an outsourced commodity in other countries too, causing a uptick in market capitalization.	Eating meat is part of culture/tradition
the meat industry is thriving and reducing consumption could hurt the economy and take away jobs from those in that industry.	Less meat consumption could harm economy and cut jobs
meat is a much loved food all around the globe.	People will or should still eat meat
the meat industry is thriving because of it.	The meat industry is important/thriving and/or exports/demand increasing
CAN BE HEALTH FOR SOME PEOPLE	Eating meat is necessary for good nutrition
it is a large economic drive for a lot of workers and families.	Meat creates jobs and benefits economy
is helpful to the economy in the jobs it provides.	Meat creates jobs and benefits economy
the meat industry is thriving and to cease would cause people to lose their jobs.	Less meat consumption could harm economy and cut jobs
the meat industry is making more money thereby creating more jobs.	Meat creates jobs and benefits economy
the meat industry is very important the economy.	Meat creates jobs and benefits economy
the meat industry is a thriving market and taking that away would ruin a lot of jobs.	Less meat consumption could harm economy and cut jobs
the industry is thriving and reducing consumption would hurt the economy.	Less meat consumption could harm economy and cut jobs
livestock production is also a boon to our economy.	Meat creates jobs and benefits economy
it is a tradition to eat meat.	Eating meat is part of culture/tradition
it is important to make sure animal populations are kept under control.	Outside of article's scope
meat is a very important part of American culture, diet, and tradition.	Eating meat is part of culture/tradition
the meat industry is a dominating force in the American domestic market.	The meat industry is important/thriving and/or exports/demand increasing
the meat industry is an important part of our economy.	Meat creates jobs and benefits economy
meat is an irreplaceable part of most American diets	Eating meat is necessary for good nutrition
the meat industry is still thriving because even if American's slow down on eating meat, the foreign world is ramping their numbers up.	The meat industry is important/thriving and/or exports/demand increasing
meat production is thriving.	The meat industry is important/thriving and/or exports/demand increasing
meat is also an important part of many cultures.	Eating meat is part of culture/tradition
the meat industry is thriving.	The meat industry is important/thriving and/or exports/demand increasing
meat is an important part of anyone's diet.	People will or should still eat meat
the domestic meat industry is an important part of the economy that supplies a lot of jobs.	Meat creates jobs and benefits economy
the meat industry is rising  reducing  could damage an important position in the infrastructure hurting industry  economy and loss of precious jobs.	Less meat consumption could harm economy and cut jobs
the industry is booming and is a vital part of the economy.	Meat creates jobs and benefits economy
it is a boon to domestic industry, helping the economy and adding precious jobs.	Meat creates jobs and benefits economy
it is an american tradition.	Eating meat is part of culture/tradition
there is a large likelihood that the vast tracks of farmland needed for grazing animals would not be left empty, there would be another, perhaps more harmful to the environment industry to use the land and resources.	Outside of article's scope
the economy behind meat production is booming.	Meat creates jobs and benefits economy
the meat industry is thriving because now people around the world are integrating meats into their daily diets.	The meat industry is important/thriving and/or exports/demand increasing
meat consumption is an integral part of American social and business tradition.	Eating meat is part of culture/tradition
it is also a large part of the American economy.	Meat creates jobs and benefits economy
it is also an intricate part of American culture and it is steeped in our traditions.	Eating meat is part of culture/tradition
the meat industry is thriving and exports are increasing.	The meat industry is important/thriving and/or exports/demand increasing
meat consumption is on the rise with more and more countries increasing their meat consumption.	The meat industry is important/thriving and/or exports/demand increasing
some people choose to be flexitarians	Flexitarian w/o connection to environment or jobs
it is also good for the economy.	Meat creates jobs and benefits economy
America's economy is sustained because of meat exports.	Meat creates jobs and benefits economy
the meat industry is also providing many jobs.	Meat creates jobs and benefits economy
the meat industry is thriving and therefore reducing meat consumption could damage the economy.	Less meat consumption could harm economy and cut jobs
the industry is a large part of the American economy.	Meat creates jobs and benefits economy
it is a thriving industry and a stable part of the american diet	The meat industry is important/thriving and/or exports/demand increasing
it is helping the economy because of exports to other countries.	Meat creates jobs and benefits economy
the demand is increasing due to increased levels of consumption outside the United States.	The meat industry is important/thriving and/or exports/demand increasing
It is a booming economy furnishing many jobs.	Meat creates jobs and benefits economy
the industry is thriving due to increased exports and new jobs.	The meat industry is important/thriving and/or exports/demand increasing
the beef industry is thriving and without it, many people would lose their jobs.	Less meat consumption could harm economy and cut jobs
it is a booming industry both domestically and internationally.	The meat industry is important/thriving and/or exports/demand increasing
the meat industry is thriving and growing, even internationally.	The meat industry is important/thriving and/or exports/demand increasing
the meat industry is thriving due to more countries integrating meat into their diets.	The meat industry is important/thriving and/or exports/demand increasing
the same is also providing jobs and improving the economy.	Meat creates jobs and benefits economy
the meat industry is thriving and produces jobs while helping the economy.	Meat creates jobs and benefits economy
the meat industry is growing and becoming more global, providing jobs and improving the economy.	Meat creates jobs and benefits economy
it is good for the economy and jobs.	Meat creates jobs and benefits economy
the meat industry is thriving, and as a result the consumption of meat has lead to a thriving industry and jobs.	Meat creates jobs and benefits economy
the meat industry is thriving therefore reducing meat consumption could damage an important domestic industry, hurting the economy and taking away precious jobs.	Less meat consumption could harm economy and cut jobs
the meat industry is thriving and accounts for many jobs, as well as several pivotal culinary pieces of American culture.	Meat creates jobs and benefits economy
the meat industry is an important part of the economy, and taking it away entirely would be a threat to the economy, and would take away jobs.	Less meat consumption could harm economy and cut jobs
meat consumption is part of American culture and tradition.	Eating meat is part of culture/tradition
the meat industry is thriving, reducing meat consumption could damage an important domestic industry, hurting the economy and taking away precious jobs.	Less meat consumption could harm economy and cut jobs
is a large, profitable domestic industry.	The meat industry is important/thriving and/or exports/demand increasing
meat is also a source of the U.S. economy.	Meat creates jobs and benefits economy
the industry is good for the economy.	Meat creates jobs and benefits economy
is helping the meat industry thrive with an increase in meat exports.	The meat industry is important/thriving and/or exports/demand increasing
the meat industry is thriving and reducing meat consumption would hurt the economy and lose jobs.	Less meat consumption could harm economy and cut jobs
it is giving people in the meat industry more jobs.	Meat creates jobs and benefits economy
meat production is vital for US economy since US consumes consumes a lot of meat domestically and exports the meat abroad.	Meat creates jobs and benefits economy
it is part of the culture of the people.	Eating meat is part of culture/tradition
the meat industry is thriving domestically and abroad as exports increase and more countries integrate meat into their daily diets than before.	The meat industry is important/thriving and/or exports/demand increasing
meat is to delicious to give up.	People will or should still eat meat
it is also a vital part of the U.S. economy, so you have to be careful if you want to reduce its impact.	Meat creates jobs and benefits economy
some would say that human effect on the environment in any way is minimal.	Outside of article's scope
our water supply is in reality adequate to raise livestock so that we can eat meat.	Outside of article's scope
it is an essential part of our culture.	Eating meat is part of culture/tradition
it is essential for humans to have protein in their diet to be healthy	Eating meat is necessary for good nutrition
it is helping our economy tremendously.	Meat creates jobs and benefits economy
it is part of our culture	Eating meat is part of culture/tradition
meat consumption is an integral part of human diet	Eating meat is necessary for good nutrition
it is part of the american gastronomy and will be very dificult to eliminate it comsuption	Eating meat is necessary for good nutrition
meat is a great source of protein and can aid in our general health.	Eating meat is necessary for good nutrition
it is producing Jobs for Americans.	Meat creates jobs and benefits economy
there is time to turn it around	Change without mentioning consumption
meat is tasty and people will pay to eat it - economies rely on it.	The meat industry is important/thriving and/or exports/demand increasing
it is a money making domestic industry for the US.	The meat industry is important/thriving and/or exports/demand increasing
it is still needed so we need to find a better way for us to produce the meat we need.	Change without mentioning consumption
our country's economy is becoming increasingly dependent on exports to other countries where meat consumption has increased.	Meat creates jobs and benefits economy
is important in the domestic industry.	The meat industry is important/thriving and/or exports/demand increasing
it is a booming sector of the economy.	Meat creates jobs and benefits economy
meat consumption is a large part of American life, especially during periods of celebration.	Eating meat is part of culture/tradition
the meat industry is a vital part of our economy.	Meat creates jobs and benefits economy
is also creating a healthy economy.	Meat creates jobs and benefits economy
there is a way for Americans to still eat meat while reducing the environmental impact of their dietary choices.	Flexitarians benefit environment
protein is good for the body.	Eating meat is necessary for good nutrition
meat production is good for the economy and is an integral part of many people's lifestyle.	Meat creates jobs and benefits economy
it is an important domestic industry and provides jobs to many people.	Meat creates jobs and benefits economy
it is helping our economy.	Meat creates jobs and benefits economy
the meat industry is thriving being that most of the beef is eaten by Americans and the meat exports to other countries have increased.	The meat industry is important/thriving and/or exports/demand increasing
it is important to the American economy.	Meat creates jobs and benefits economy
meat consumption is an important & natural part of human diets worldwide.	People will or should still eat meat
meat is a large economic beneficiary.	Meat creates jobs and benefits economy
the  meat industry is thriving.	The meat industry is important/thriving and/or exports/demand increasing
everyone is eating it.	People will or should still eat meat
the meat industry is thriving and provides many jobs.	Meat creates jobs and benefits economy
more meat is being brought outside of the US as there is a large presence of it being made and consumed in the United States.	The meat industry is important/thriving and/or exports/demand increasing
due to exports, the meat industry is prospering and creating many new jobs.	Meat creates jobs and benefits economy
meat is a staple around many U.S. holidays and traditions.	Eating meat is part of culture/tradition
the economy is doing quite well in this sector.	Meat creates jobs and benefits economy
meat industry is thriving and giving jobs to many people.	Meat creates jobs and benefits economy
but an alternative is to eat meat on occasion and eat fish and plants more frequently.	Flexitarian w/o connection to environment or jobs
a diet with at least occasional meat consumption is healthier than not ever eating meat.	Flexitarian w/o connection to environment or jobs
the meat industry is a powerful world economy.	Meat creates jobs and benefits economy
the meat industry is also a large part of the U.S. economy.	Meat creates jobs and benefits economy
meat consumption, in moderation, is healthy for people's bodies.	Flexitarian w/o connection to environment or jobs
because the industry is so large and supports so many workers, any reduction of meat consumption could have negative effects on the economy through the loss of wages.	Less meat consumption could harm economy and cut jobs
is also employing thousands of people in the livestock and agricultural field.	Meat creates jobs and benefits economy
it is also driving the economy.	Meat creates jobs and benefits economy
is needed in the daily life.	People will or should still eat meat
meat is an essential part of the American culture and would be nearly impossible to give up entirely.	Eating meat is part of culture/tradition
that is disputable.	Outside of article's scope
it wouldn't be economical to reduce meat consumption because it might hurt the country's economy.	Less meat consumption could harm economy and cut jobs
the meat industry is still thriving.	The meat industry is important/thriving and/or exports/demand increasing
the meat industry is important to the economy.	Meat creates jobs and benefits economy
meat consumption is a large industry with a huge economic impact.	Meat creates jobs and benefits economy
it is providing jobs	Meat creates jobs and benefits economy
moderate meat consumption can be healthy and doing away with meat production would cause the loss of many jobs	Less meat consumption could harm economy and cut jobs
the consequences can be reduced if people choose to eat less meat.	Flexitarians benefit environment
can be eaten in moderation.	Flexitarian w/o connection to environment or jobs
consumption of meat and fish can be healthy and responsible if done in moderation.	Flexitarians benefit environment
in moderation meat consumption can still be healthy and responsible.	Flexitarians benefit environment
meat and fish can be healthy and responsible choices if consumed in moderation.	Plagiarism
can be healthy if consumed in moderatopm	Plagiarism
meat and fish can be healthy and responsible choices if consumed in moderation.	Plagiarism
that meat and fish can be healthy and responsible choices if consumed in moderation.	Plagiarism
, can be beneficial for the human body, in terms of consuming proteins.	Eating meat is necessary for good nutrition
meat and fish can be healthy and responsible choices if consumed in moderation.	Plagiarism
it can be healthy for your diet	Eating meat is necessary for good nutrition
they can be improved by simple changes.	Change without mentioning consumption
this can be mitigated by cutting back on meat consumption per capita.	Flexitarians benefit environment
meat can be used as a responsible choice.	Flexitarian w/o connection to environment or jobs
it can be a healthy option if consumed in moderation.	Flexitarian w/o connection to environment or jobs
can be eaten in moderation.	Flexitarian w/o connection to environment or jobs
it can be healthy and responsible choice if consumed in moderation.	Plagiarism
this could be reduced if people ate more vegetables instead of meat.	Flexitarians benefit environment
LIMITING CONSUMPTION COULD BE ECONOMINCALLY HARMFUL AND CAUSE LOSS OF EMPLOYMENT WITHIN THE INDUSTRY.	Less meat consumption could harm economy and cut jobs
these issues could be controlled by better logistics of  transport of meat products, or keeping farms local to supply their nearby residents only.	Outside of article's scope
it could be resolved in a substainable way if the practices are done correctly	Change without mentioning consumption
it may be difficult for people to stop, because we have such strong cultural associations with a lot of meat eating.	Eating meat is part of culture/tradition
there may be a negative economic impact to reducing meat consumption and also exporting meats as part of our international trade economy.	Less meat consumption could harm economy and cut jobs
it may be an essential process in order to keep our economy thriving.	Meat creates jobs and benefits economy
some believe it may not be such a bad thing if consumed in moderation.	Flexitarian w/o connection to environment or jobs
small amounts occasionally may be OK.	Flexitarian w/o connection to environment or jobs
many Americans might be hesitant to reduce their amount of meat consumed because of cultural expectations around holidays and certain foods.	Eating meat is part of culture/tradition
a solution might be to greatly reduce the amount of meat in the average American diet.	Flexitarians benefit environment
should be reduced to moderate intake.	Flexitarian w/o connection to environment or jobs
should be consumed in moderation.	Flexitarian w/o connection to environment or jobs
the economy would be hurt by stopping meat production because it provides a lot of jobs.	Less meat consumption could harm economy and cut jobs
the economy would be hurt if we stopped eating meat entirely.	Less meat consumption could harm economy and cut jobs
a logical alternative would be to engineer more environmentally friendly ways to produce meat.	Outside of article's scope
becoming a flexitarian could help reduce the problem.	Flexitarians benefit environment
becoming a flexitarian can be an option	Flexitarian w/o connection to environment or jobs
being flexible in food choices can help.	Flexitarians benefit environment
being a flexitarian will help decrease harm to the environment.	Flexitarians benefit environment
being a flexitarian is also an option that provides some relief but is not as drastic of a dietary change.	Flexitarians benefit environment
being a flexitarian eating  meat only sometimes can help	Flexitarians benefit environment
the amount of meat being consumed is allowing the meat industry to thrive, providing thousands of jobs.	Meat creates jobs and benefits economy
consumption--along with being part of people's traditions--also helps feed a growing amount of people.	Eating meat is part of culture/tradition
flexitarians believe that a diet should be mostly plant-based, but that meat and fish can be healthy and responsible choices if consumed in moderation.	Flexitarians benefit environment
cattle farmers and others do not believe that to be true.	Outside of article's scope
it benefit domestic industry, economy and precious jobs	Meat creates jobs and benefits economy
benefiting the economy.	Meat creates jobs and benefits economy
the economy also benefits from the jobs created and revenue provided through raising livestock for food.	Meat creates jobs and benefits economy
the economy benefits from the sale of meat because meat has become a profitable export.	Meat creates jobs and benefits economy
it benefits us economically.	Meat creates jobs and benefits economy
some people that call themselves "Flexitarians" choose to eat meat in moderation.	Flexitarian w/o connection to environment or jobs
some people called flexitarians are opting to eat meat in moderation	Flexitarian w/o connection to environment or jobs
people called "flexitarians" are consuming meat in moderation so they still enjoy meat but cut down on consumption and negative environmental impact.	Flexitarians benefit environment
we still dont care about the environment.	Outside of article's scope
caring and raising the livestock produces jobs.	Meat creates jobs and benefits economy
the elimination of meat in human nutrition can cause nutritional deficiencies and cause people to lose many jobs.	Less meat consumption could harm economy and cut jobs
many people won't change their diet because family traditions would have to change.	Eating meat is part of culture/tradition
flexitarians can change that.	Flexitarians benefit environment
changing our meat-eating habits would hurt traditions and the economy.	Less meat consumption could harm economy and cut jobs
choosing not to consume meat can damage the domestic industry and take away jobs.	Less meat consumption could harm economy and cut jobs
many people still chose to continue eating meat despite knowing this.	People will or should still eat meat
seventy-five percent of the greenhouse gases in our environment come from other sources, and reducing consumption can hurt economies and employment.	Less meat consumption could harm economy and cut jobs
eighty percent of greenhouse gas emissions come from other factors, so meat isn't the major contributor.	Outside of article's scope
large amounts of greenhouse gases come from cars, planes, and trucks.	Outside of article's scope
huge amounts of pollution also come from developing countries, which are increasing their use of automobiles and coal burning power plants.	Outside of article's scope
most people connect it with cultural traditions.	Eating meat is part of culture/tradition
Many Americans consider meat to be a part of their culture.	Eating meat is part of culture/tradition
people consider it part of our culture and other societies have been eating more meat.	Eating meat is part of culture/tradition
peoples could not consider that and not giving importance to them.	Outside of article's scope
you can still consume it in moderation along with a more plant-based diet.	Flexitarian w/o connection to environment or jobs
if people could consume meat more moderately/sparingly it would benefit both the economy and the environment.	Flexitarians benefit environment
if consumed in moderation, can be less harmful to the environment.	Flexitarians benefit environment
meat consumed in moderation can still be sustainable.	Flexitarians benefit environment
if people consumed less, it can negatively affect jobs and the economy.	Less meat consumption could harm economy and cut jobs
consuming less meat may hurt the economy and cause job loss.	Less meat consumption could harm economy and cut jobs
consuming meat is apart of American culture.	Eating meat is part of culture/tradition
consuming meat can also be a healthy part of one's diet.	Eating meat is necessary for good nutrition
consuming small amounts of meat will create less damage to the environment and create fewer greenhouse gases.	Flexitarians benefit environment
Americans continue to consume.	People will or should still eat meat
we still continue to eat them.	People will or should still eat meat
the meat industry continues to thrive.	The meat industry is important/thriving and/or exports/demand increasing
the meat industry continues to thrive as more and more meat is consumed.	The meat industry is important/thriving and/or exports/demand increasing
the meat house industry continues to thrive.	The meat industry is important/thriving and/or exports/demand increasing
the demand for it continues to rise, meaning that any limits on meat production could have negative implications for economies home and abroad.	Less meat consumption could harm economy and cut jobs
meat consumption continues to rise.	People will or should still eat meat
continuing to eat meat less often could help change the current level of pollution and waste.	Flexitarians benefit environment
contribute economically to society.	Meat creates jobs and benefits economy
it contributes to a strong, American culture as well as a strong international marketplace.	The meat industry is important/thriving and/or exports/demand increasing
cooking and eating meat remains a staple of American culture.	Eating meat is part of culture/tradition
you can counteract this by changing other actions like driving less and buying fewer goods.	Change without mentioning consumption
they create  and contribute to the over all domestic industry and economy.	Meat creates jobs and benefits economy
also create jobs and sustain much of the economy in the U.S.	Meat creates jobs and benefits economy
also create a ton of jobs and helps the economy.	Meat creates jobs and benefits economy
does create jobs and has the meat industry thriving.	Meat creates jobs and benefits economy
the meat industry also created many jobs domestically.	Meat creates jobs and benefits economy
it creates jobs and is good for the economy.	Meat creates jobs and benefits economy
it creates jobs	Meat creates jobs and benefits economy
creates jobs for the people.	Meat creates jobs and benefits economy
meat production creates a lot of jobs and is an essential part of the American diet.	Meat creates jobs and benefits economy
that industry creates many jobs.	Meat creates jobs and benefits economy
it creates many jobs and money.	Meat creates jobs and benefits economy
it creates jobs and have economic benefits.	Meat creates jobs and benefits economy
it creates green house gasses	Meat consumption harms environment
it creates a thriving industry.	The meat industry is important/thriving and/or exports/demand increasing
it creates a thriving economic industry with lots of jobs.	Meat creates jobs and benefits economy
the meat industry creates many jobs and contributes to a healthy economy	Meat creates jobs and benefits economy
the meat industry also creates good jobs.	Meat creates jobs and benefits economy
the meat industry creates jobs for people.	Meat creates jobs and benefits economy
the meat industry creates a lot of jobs for Americans.	Meat creates jobs and benefits economy
the meat industry also creates precious jobs as more meat is exported, boosting the economy.	Meat creates jobs and benefits economy
curbing meat consumption would harm the economy.	Less meat consumption could harm economy and cut jobs
to cut out meat eating would harm the USA economy.	Less meat consumption could harm economy and cut jobs
if cut it would cause precious jobs to be lost and hurt our economy.	Less meat consumption could harm economy and cut jobs
If people cut back thatvwouod help.	Flexitarians benefit environment
if people cut back we can help the environment while still eating meat.	Flexitarians benefit environment
if we cut down on our meat consumption this would help.	Flexitarians benefit environment
if we cut down on meat consumption, we are taking away many jobs that Americans rely on.	Less meat consumption could harm economy and cut jobs
if we all cut back on eating meat many jobs will be lost.	Less meat consumption could harm economy and cut jobs
cutting down meat consumption could lead to job loss as well as hurt the economy.	Less meat consumption could harm economy and cut jobs
CUTTING BACK COULD HURT THE ECONOMY AND THE INDUSTRY AS A WHOLE.	Less meat consumption could harm economy and cut jobs
cutting back consumption would hurt the economy.	Less meat consumption could harm economy and cut jobs
cutting back on consumption of meat could harm the thriving domestic meat industry and hurt jobs.	Less meat consumption could harm economy and cut jobs
a drastic reduction in meat consumption could damage the economy by decreasing jobs and erasing livelihoods.	Less meat consumption could harm economy and cut jobs
it could damage a important  part of the domestic industry.	Less meat consumption could harm economy and cut jobs
it would damage our economy to make a change.	Less meat consumption could harm economy and cut jobs
to decrease such a thriving business would hurt the economy.	Less meat consumption could harm economy and cut jobs
decreasing the amounts of meat consumed could damage an important domestic industry since exports are increasing.	Less meat consumption could harm economy and cut jobs
decreasing meat consumption could damage important domestic industry, hurt the economy and take away jobs.	Less meat consumption could harm economy and cut jobs
decreasing meat production could harm the economy.	Less meat consumption could harm economy and cut jobs
by decreasing the amount of meat eaten, there would be many lost job, and the USA would lose an important domestic industry.	Less meat consumption could harm economy and cut jobs
decreasing meat consumption could harm meat industry, the economy, and decrease jobs.	Less meat consumption could harm economy and cut jobs
decreasing consumption of these products, especially of beef, could free up massive quantities of grain and reduce pressure on land.	Flexitarians benefit environment
decreasing the amount consumed by this country and other countries could manage the industry and its workers.	Flexitarians benefit environment
decreasing the production of meat could cause people to lose their jobs.	Less meat consumption could harm economy and cut jobs
many jobs depend on the industry.	Less meat consumption could harm economy and cut jobs
the economy depends on meats and its exports to survive and thrive.	Meat creates jobs and benefits economy
its being destroyed by practically everything now so I wouldnt be too concerned.	Outside of article's scope
destroying the meat industry could destroy an important domestic industry.	Less meat consumption could harm economy and cut jobs
many Americans eat meat because of traditions.	Eating meat is part of culture/tradition
people still eat it often,however eating it in moderation would be less toxic.	Flexitarians benefit environment
if people eat meat in moderation, the resources could be more rationed.	Flexitarian w/o connection to environment or jobs
so many people in America eat meat and it is like part of our culture.	Eating meat is part of culture/tradition
some people like Flexitarians only eat meat occasionally, which in turn helps the environment more.	Flexitarians benefit environment
if we eat meat in moderation that may help solve the problem and not eliminate too many jobs.	Flexitarians benefit environment
if we eat fish and meat in moderation we can cut down on those greenhouse gases.	Flexitarians benefit environment
eaten in moderation it is okay according to many people who label themselves "Flexitarians."	Flexitarian w/o connection to environment or jobs
if eaten in moderation this could change.	Flexitarians benefit environment
if eaten responsibly and in moderation, meat can be a valuable part of a regular diet.	Flexitarians benefit environment
if eaten in small amounts or moderation it is perfectly fine.	Flexitarian w/o connection to environment or jobs
occasionally eating meat and mainly focusing on a plant based diet can reduce the harm	Flexitarians benefit environment
not eating eat could also hurt the economy with people losing jobs.	Less meat consumption could harm economy and cut jobs
eating meat in moderation may lessen the harm we are doing to the environment	Flexitarians benefit environment
eating less meat could harm the economy.	Less meat consumption could harm economy and cut jobs
eating meat will provide nutrients, which support muscle and brain function in the body.	Eating meat is necessary for good nutrition
eating meat occasionally doesn't hurt our health.	People will or should still eat meat
eating small amounts could be beneficial to our health.	Eating meat is necessary for good nutrition
eating meat is a part of our traditions that most people probably would never give up.	Eating meat is part of culture/tradition
eating meat and fish in moderation can be healthy and responsible.	Flexitarians benefit environment
eating meats is an American tradition.	Eating meat is part of culture/tradition
eating meat is part of the American culture.	Eating meat is part of culture/tradition
eating less meat could eat a large industry, affect the economy and take away jobs.	Less meat consumption could harm economy and cut jobs
eating meat is part of American cultural traditions, and people would not want to give that up.	Eating meat is part of culture/tradition
eating meat in moderation could be a good middle ground.	Flexitarian w/o connection to environment or jobs
eating in moderation can help the environment	Flexitarians benefit environment
eating meat occasionally, as per flexitarianism, can be seen as a responsible option.	Flexitarians benefit environment
eating meat is a part of American culture and tradition, representing holidays and local pride.	Eating meat is part of culture/tradition
eating meat occasionally can still be healthy for you.	Flexitarian w/o connection to environment or jobs
eating meat is an essential part of many cultures and traditions.	Eating meat is part of culture/tradition
eating it in moderation would help reduce need for meat.	Flexitarians benefit environment
eating meat is an American tradition that would be difficult to change and also would cost many much needed jobs.	Less meat consumption could harm economy and cut jobs
eating meat is part of our traditions.	Eating meat is part of culture/tradition
eating some isn't too bad	Flexitarian w/o connection to environment or jobs
eating meat occasionally can be a healthy part of our diets.	Flexitarian w/o connection to environment or jobs
eating more meat is what gave humans the large brains we now enjoy.	Outside of article's scope
eating meat is part of American culture.	Eating meat is part of culture/tradition
eating meat has a staple in American culture.	Eating meat is part of culture/tradition
the American tradition of eating meat is hurting the earth.	Meat consumption harms environment
eating meat in moderation can be a healthy option.	Flexitarian w/o connection to environment or jobs
eating meat is an essential part of a healthy diet if done in moderation.	Flexitarian w/o connection to environment or jobs
eating meat is a part of the culture.	Eating meat is part of culture/tradition
eating some meat does have it's benefits.	Flexitarian w/o connection to environment or jobs
eating meat is an essential part of American culture and traditions.	Eating meat is part of culture/tradition
for Americans eating meat is considered tradition.	Eating meat is part of culture/tradition
with more people eating meat, the meat industry is incredibly robust and is providing economic opportunity for many people.	Meat creates jobs and benefits economy
could the American tradition of eating meat be hurting the earth	Meat consumption harms environment
if we do away with eating meat, the economy will be drastically damaged.	Less meat consumption could harm economy and cut jobs
everyone eats meat, so it's basically impossible to just stop meat production.	People will or should still eat meat
educing meat consumption could damage an important domestic industry, hurting the economy and taking away precious jobs.	Less meat consumption could harm economy and cut jobs
eliminating meat would be like giving up an essential part of Americans' culture and traditions.	Eating meat is part of culture/tradition
eliminating the consumption to drastically could negatively affect economies.	Less meat consumption could harm economy and cut jobs
eliminating them would hurt the economy and cause loss of jobs.	Less meat consumption could harm economy and cut jobs
eliminating meat by Americans would be like giving up an essential part of their culture and traditions.	Eating meat is part of culture/tradition
for some Americans, eliminating meat would be like giving up an essential part of our culture and traditions	Eating meat is part of culture/tradition
eliminating meat would be giving up a part of their culture.	Eating meat is part of culture/tradition
eliminating all meat consumption would likely harm the economy.	Less meat consumption could harm economy and cut jobs
eliminating meat would be like giving up an essential part of our culture.	Eating meat is part of culture/tradition
eliminating meat would be like giving up an essential part of our culture and traditions	Eating meat is part of culture/tradition
eliminating consumption of meat would hurt the economy and take away many meat-related jobs.	Less meat consumption could harm economy and cut jobs
eliminating the meat industry would hurt the economy in many ways.	Less meat consumption could harm economy and cut jobs
eliminating meat would be like giving up an essential part of our culture and traditions.	Eating meat is part of culture/tradition
For some Americans, eliminating meat would be like giving up an essential part of our culture and traditions.	Eating meat is part of culture/tradition
eliminating meat consumption would harm the economy.	Less meat consumption could harm economy and cut jobs
eliminating all meat consumption could negatively impact the economy and eliminate jobs.	Less meat consumption could harm economy and cut jobs
eliminating the livestock would cause harm to the economy for food producers.	Less meat consumption could harm economy and cut jobs
eliminating meat would be like eliminating some of American culture.	Eating meat is part of culture/tradition
eliminating the meat industry would eliminate jobs and negatively affect the economy.	Less meat consumption could harm economy and cut jobs
eliminating meat would be like giving up an essential  part of our culture and traditions.	Eating meat is part of culture/tradition
eliminating meat production would create an employment crisis in this country.	Less meat consumption could harm economy and cut jobs
eliminating use would take away jobs and damage the economy.	Less meat consumption could harm economy and cut jobs
eliminating consumption could damage an important domestic industry which, in turn, could damage the economy.	Less meat consumption could harm economy and cut jobs
for some Americans, eliminating meat would be like giving up an essential part of our culture and traditions.	Eating meat is part of culture/tradition
eliminating the meat industry would take away jobs and livelihoods that are important to the economy.	Less meat consumption could harm economy and cut jobs
eliminating meat entirely would cripple the meat industry, making people lose jobs.	Less meat consumption could harm economy and cut jobs
eliminating meat from most American's diets will be living giving up an essential part of culture and traditions.	Eating meat is part of culture/tradition
eliminating them will mean loss of jobs, cultural identity and could hamper a thriving economy.	Less meat consumption could harm economy and cut jobs
eliminating the meat industry completely would severely hurt the economy.	Less meat consumption could harm economy and cut jobs
for some Americans eliminating meat would be like giving up an essential part of our culture and traditions.	Eating meat is part of culture/tradition
eliminating meat would be giving up essential US culture.	Eating meat is part of culture/tradition
eliminating meat from our diets would also eliminate meat industry jobs and harm our economy.	Less meat consumption could harm economy and cut jobs
without this industry, it would end up hurting the economy and taking away precious jobs.	Less meat consumption could harm economy and cut jobs
Americans enjoy consuming meat so much that the industry is thriving.	The meat industry is important/thriving and/or exports/demand increasing
exported meat is making a lot of profit.	The meat industry is important/thriving and/or exports/demand increasing
farming for meat and other entities related to that (e.g., transportation, sales) create jobs for people and consuming meat is a part of American culture.	Meat creates jobs and benefits economy
Americans feel that it is an important part of their culture.	Eating meat is part of culture/tradition
many people feel eating meat is a part of their culture.	Eating meat is part of culture/tradition
many Americans find meat as a large part of their culture.	Eating meat is part of culture/tradition
God gave us meat to eat after the flood as part of our nutritional needs	Eating meat is necessary for good nutrition
getting rid of meat entirely could be hurting a vital economic sector.	Less meat consumption could harm economy and cut jobs
getting rid of the meat industry would really hurt the economy.	Less meat consumption could harm economy and cut jobs
getting rid of the meat industry could hurt the economy.	Less meat consumption could harm economy and cut jobs
many people will not give up meat consumption for cultural reasons.	Eating meat is part of culture/tradition
who gives a shit as long as I get to eat dead animals.	People will or should still eat meat
some people feel like giving up meat would be like giving up our culture and traditions.	Eating meat is part of culture/tradition
giving up meat could be devastating to many culture around the world.	Eating meat is part of culture/tradition
giving up eating meat would be like giving up an essential part of the American culture and tradition.	Eating meat is part of culture/tradition
giving up meat could take away people's jobs.	Less meat consumption could harm economy and cut jobs
for Americans giving up meat would be like giving up an essential part of their culture	Eating meat is part of culture/tradition
giving many people jobs!	Meat creates jobs and benefits economy
giving jobs loacally.	Meat creates jobs and benefits economy
for some Americans giving up meat would be counter to their culture.	Eating meat is part of culture/tradition
due to growing export demands, the meat industry is thriving.	The meat industry is important/thriving and/or exports/demand increasing
so does growing fruits and vegetables, so how it that helping by eating more of them.	Outside of article's scope
it would harm the economy if meat production was reduced.	Less meat consumption could harm economy and cut jobs
reduction in meat consumption would harm a large industry and potentially hurt individuals and the economy when jobs are lost.	Less meat consumption could harm economy and cut jobs
harming the meat industry, an important domestic industry, could be detrimental to the economy.	Less meat consumption could harm economy and cut jobs
its not the only thing harming the environment the pollution by cars, trucks, trains, and airplanes cause it also	Outside of article's scope
meat consumption has created an industry where it plays a role in the economy and jobs creation.	Meat creates jobs and benefits economy
the rise in meat consumption has created important jobs and contributed to improvements in the economy.	Meat creates jobs and benefits economy
this has led to increased market for the meat industry, creating more job opportunities for a better economy.	Meat creates jobs and benefits economy
it has become so essential in our economy and life’s that it would be hard to stop it without having consequences.	Less meat consumption could harm economy and cut jobs
the popularity of meat consumption has improved local and national economy.	Meat creates jobs and benefits economy
it has helped the domestic meat industry.	The meat industry is important/thriving and/or exports/demand increasing
neat has become a lucrative export.	The meat industry is important/thriving and/or exports/demand increasing
meat has become such a normal role in our lives many people would not be willing to give that up.	People will or should still eat meat
Livestock farming has a vast environmental footprint.	Meat consumption harms environment
some people have adjusted their diet to limited but not fully stop eating meat.	Flexitarian w/o connection to environment or jobs
we have to eat	People will or should still eat meat
some consumers have opted for other options such as becoming flexitarians.	Flexitarian w/o connection to environment or jobs
some vegetarians have opted to become "Flexitarians" who focus on plant-based consumption with occasionally responsible meat eating.	Flexitarians benefit environment
many Americans have meat heavily integrated into their diets	Eating meat is part of culture/tradition
many Americans have cultural reasons for eating meat, like celebrating holidays.	Eating meat is part of culture/tradition
our bodies have health needs that include consuming meat from time to time, which forces our hands to knowingly cause harm.	Eating meat is necessary for good nutrition
a significant reduction would have a negative economic effect on the meat industry.	Less meat consumption could harm economy and cut jobs
people would have a very hard time giving up meat consumption.	People will or should still eat meat
having us get rid of eating meat could harm a domestic industry.	Less meat consumption could harm economy and cut jobs
exports of meat help the economy.	Meat creates jobs and benefits economy
they help domestic industries and create jobs.	Meat creates jobs and benefits economy
they help the economy by maintaining or creating jobs.	Meat creates jobs and benefits economy
vegetarians help reduce the greenhouse gases by not eating meat.	Flexitarians benefit environment
we can help prevent this.	Change without mentioning consumption
they do help maintain a domestic industry and create jobs.	Meat creates jobs and benefits economy
we can do things to help it.	Change without mentioning consumption
helping keep alot of domestic jobs.	Meat creates jobs and benefits economy
helping the economy as more and more countries adopt meat eating.	Meat creates jobs and benefits economy
helping meat producers.	Meat creates jobs and benefits economy
also helping the economy because meat is a large export as more countries become Americanized.	Meat creates jobs and benefits economy
it helps solve the hunger problem in other areas and there is a demand.	The meat industry is important/thriving and/or exports/demand increasing
it helps to create jobs.	Meat creates jobs and benefits economy
it also helps the economy through importing meat to different countries.	Meat creates jobs and benefits economy
it helps the economy.	Meat creates jobs and benefits economy
it also helps the economy by creating jobs.	Meat creates jobs and benefits economy
helps the economy by creating lucrative jobs.	Meat creates jobs and benefits economy
also helps the economy a great deal.	Meat creates jobs and benefits economy
meat consumption helps an important domestic industry, creating jobs.	Meat creates jobs and benefits economy
the American meat industry helps strengthen the US economy.	Meat creates jobs and benefits economy
the meat industry helps drive out economy.	Meat creates jobs and benefits economy
the meat industry helps the economy and provides jobs for people.	Meat creates jobs and benefits economy
It can hurt the economy and take away precious job.	Less meat consumption could harm economy and cut jobs
a decrease in the consumption of meat could hurt the economy and make people lose jobs.	Less meat consumption could harm economy and cut jobs
it could hurt American businesses and jobs.	Less meat consumption could harm economy and cut jobs
it will also hurt the economy and the industry if consumption decreases.	Less meat consumption could harm economy and cut jobs
it would hurt the economy if we lowered our meaat consumption as many industries rely on meat consumption.	Less meat consumption could harm economy and cut jobs
it would hurt the economy if we eliminate the meat industry.	Less meat consumption could harm economy and cut jobs
It would hurt the economy if people stopped eating meat altogether.	Less meat consumption could harm economy and cut jobs
would hurt the US economy if we did away with it altogether.	Less meat consumption could harm economy and cut jobs
it would hurt our culture to stop eating meat.	Eating meat is part of culture/tradition
its hurting the economy	Less meat consumption could harm economy and cut jobs
some people like meat it will impact the farmland business.	Less meat consumption could harm economy and cut jobs
including meats in our diets is healthy and the meat industry provides many domestic jobs.	Meat creates jobs and benefits economy
modern diets still incorporate meat often.	People will or should still eat meat
the increased consumption is helping that segment of the economy grow which is good for wages and employees in that sector.	Meat creates jobs and benefits economy
increased the economic industry.	Meat creates jobs and benefits economy
it also increases jobs all over the country, benefiting many Americans and bringing in income.	Meat creates jobs and benefits economy
increasing export to other countries.	The meat industry is important/thriving and/or exports/demand increasing
an increasing number of people around the world are eating meat and the meat industry is thriving.	The meat industry is important/thriving and/or exports/demand increasing
the rise of "flexitarians" could indicate that meat consumption may eventually trend downwards.	Flexitarian w/o connection to environment or jobs
it a symbolic part of American culture that we integrate around several holidays.	Eating meat is part of culture/tradition
if we integrate a more plant-based diet, we can reduce that harm.	Flexitarians benefit environment
only amount to 1/5 of the total greenhouse gas creation of humans; we need to investigate the other 4/5 further.	Outside of article's scope
they involve waste of large amounts of water.	Meat consumption harms environment
cuisines involving meat are cemented in American culture and tradition.	Eating meat is part of culture/tradition
even more people keep integrating meat into their daily lives.	The meat industry is important/thriving and/or exports/demand increasing
we still keep going on.	People will or should still eat meat
some vegetarians, known as flexitarians, believe that meat can be eaten in a responsible manner in moderation.	Flexitarians benefit environment
letting go of consumption could hurt the economy, taking away precious jobs.	Less meat consumption could harm economy and cut jobs
i like it	People will or should still eat meat
loosing some of this industry could hurt economies and loose jobs.	Less meat consumption could harm economy and cut jobs
alot of people could lose there jobs if we stopped meat consumption	Less meat consumption could harm economy and cut jobs
without it many people will lose their jobs creating a poor economy that just trickles down to the rest of the population, ie. stores closing (people not having the money to buy anything but essentials, job loss, etc.	Less meat consumption could harm economy and cut jobs
still, Americans love meat and keep consuming it.	People will or should still eat meat
lowering the consumption levels to a healthy level can ween the environment concernand impact	Flexitarians benefit environment
lowering meat consumption could hurt the economy and eliminate needed jobs.	Less meat consumption could harm economy and cut jobs
some people need to eat animal protein in order to maintain their health.	Eating meat is necessary for good nutrition
will maintain the economy.	Meat creates jobs and benefits economy
its large consumption makes the industry a strong economic force and job-creator.	Meat creates jobs and benefits economy
making sudden changes to an integral part of the nation's diet and economy could have drastic negative outcomes that far outweigh the negatives of the status quo.	Less meat consumption could harm economy and cut jobs
that doesn't mean all meat eating is irresponsible.	Flexitarian w/o connection to environment or jobs
that does not mean that meat has to be eliminated from the American diet because those who follow the Flexitarian ideology eat a mainly plant based diet that is supplemented by meat.	Flexitarian w/o connection to environment or jobs
if meet consumption was eliminated, this would put all the people in the meat industry out of work.	Less meat consumption could harm economy and cut jobs
it may mess the enviormen up if stopped all at once.	Outside of article's scope
if the population moved to a more plant-based diet there would be an increase in water usage to raise plants and an increase in greenhouse gases to move the plants to processing plants and then to end-users.	Outside of article's scope
moving to a 'flexitarian' society to curtail some of the damage being done.	Flexitarians benefit environment
cars, trucks, trains, and airplanes produce more green house gases.	Outside of article's scope
most of the beef produced domestically is eaten by Americans.	Outside of article's scope
meat produced domestically can be exported and help the economy.	Meat creates jobs and benefits economy
Most of the beef produced domestically is eaten by Americans.	Irrelevant facts from article
exports of domestically produced beef is increasing allowing the meat industry to thrive.	The meat industry is important/thriving and/or exports/demand increasing
the meat industry produces many jobs which would be eliminated if meat consumption was decreased.	Less meat consumption could harm economy and cut jobs
the industry for producing meat is helping to create many jobs for people which would be lost if people stop eating meat.	Meat creates jobs and benefits economy
it may prove challenging for Americans to give up their daily diet of meat, which is strongly rooted in tradition.	Eating meat is part of culture/tradition
flexitarians provide an alternative that does not harm the environment as much,	Flexitarians benefit environment
provide many job opportunities.	Meat creates jobs and benefits economy
also provide jobs and international trade which betters our economy.	Meat creates jobs and benefits economy
these industries provide much needed jobs in the economy.	Meat creates jobs and benefits economy
provided jobs.	Meat creates jobs and benefits economy
it provides a lot of jobs for people.	Meat creates jobs and benefits economy
provides countless jobs and a large part of the economy.	Meat creates jobs and benefits economy
meat consumption not only provides the physical sustenance we need, but has long since been a large part of our culture.	Eating meat is part of culture/tradition
it provides many jobs and is ingrained in our culture.	Meat creates jobs and benefits economy
it provides many jobs.	Meat creates jobs and benefits economy
it provides employment for many people.	Meat creates jobs and benefits economy
it also provides jobs for others.	Meat creates jobs and benefits economy
the industry provides many jobs.	Meat creates jobs and benefits economy
the meat industry also provides valuable jobs and supports the economy.	Meat creates jobs and benefits economy
the meat industry provides jobs for Americans.	Meat creates jobs and benefits economy
the meat industry provides jobs.	Meat creates jobs and benefits economy
the meat industry provides jobs for many people.	Meat creates jobs and benefits economy
the meat industry provides many jobs important to the American economy.	Meat creates jobs and benefits economy
the meat industry provides many jobs.	Meat creates jobs and benefits economy
the meat industry provides jobs	Meat creates jobs and benefits economy
the meat industry provides jobs and economic benefits.	Meat creates jobs and benefits economy
the meat industry also provides jobs and helps the local economy.	Meat creates jobs and benefits economy
the meat industry provides many jobs.	Meat creates jobs and benefits economy
also providing a lot of jobs and helping the economy.	Meat creates jobs and benefits economy
in turn, providing many jobs for people as well as increasing the economy, if we were to stop production of meat, it would causes thousands of people to become jobless and lower economic value like importing goods etc.	Meat creates jobs and benefits economy
if we quit eating meat it  could damage an important industry, hurting the economy and taking away jobs.	Less meat consumption could harm economy and cut jobs
meat raised the way to was meant to be is heathy	Outside of article's scope
raising, transporting, selling and exporting meat are major industries important to the economy of the nation.	Meat creates jobs and benefits economy
Raising animals and transporting meat creates almost one-fifth of the earth’s greenhouse gases.	Meat consumption harms environment
Raising animals and transporting meat creates almost one-fifth of the earth’s greenhouse gases	Meat consumption harms environment
not raising livestock would hurt the economy because of meat that is exported.	Less meat consumption could harm economy and cut jobs
raising animals provides many jobs and helps the economy.	Meat creates jobs and benefits economy
raising its use by Americans.	Outside of article's scope
if we reduce our meat consumption it would damage domestic industry.	Less meat consumption could harm economy and cut jobs
reducing meat consumption could damage a booming industry thus leading to job loss and economic downturn.	Less meat consumption could harm economy and cut jobs
reducing meat consumption could damage an important domestic industry.	Less meat consumption could harm economy and cut jobs
reducing meat consumption could damage an important domestic industry, hurting the economy and taking away precious jobs.	Less meat consumption could harm economy and cut jobs
reducing meat consumption completely could hurting the economy and taking away precious jobs.	Less meat consumption could harm economy and cut jobs
reducing meat consumption could hurt the economy and take away jobs.	Less meat consumption could harm economy and cut jobs
reducing meat consumption could hurt the economy  and increase unemployment.	Less meat consumption could harm economy and cut jobs
reducing meat consumption could potentially hurt the economy in the long run.	Less meat consumption could harm economy and cut jobs
reducing it could hurt the economy and eliminate many jobs in the industry.	Less meat consumption could harm economy and cut jobs
abruptly reducing the amount of meat eaten could harm the economy.	Less meat consumption could harm economy and cut jobs
reducing meat consumption could hurt the national economy by taking away jobs.	Less meat consumption could harm economy and cut jobs
reducing meat production could harm an important domestic industry and creator of jobs.	Less meat consumption could harm economy and cut jobs
reducing meat consumption could damage an important domestic industry, hurting the economy and taking away precious jobs	Less meat consumption could harm economy and cut jobs
reducing meat consumption will also hurt the economies as a lot of jobs are dependent on the meat industry.	Less meat consumption could harm economy and cut jobs
reducing meat consumption could damage an important domestic industry, hurting the economy and taking away precious jobs.	Less meat consumption could harm economy and cut jobs
Reducing meat consumption could damage an important domestic industr	Less meat consumption could harm economy and cut jobs
reducing meat consumption could damage the important domestic industry, taking away precious jobs.	Less meat consumption could harm economy and cut jobs
reducing meat consumption could damage an important domestic industry, hurting the economy and taking away precious jobs.	Less meat consumption could harm economy and cut jobs
reducing meat consumption could hurt the economy by reducing jobs.	Less meat consumption could harm economy and cut jobs
reducing meat could hurt an important domestic industry.	Less meat consumption could harm economy and cut jobs
Reducing meat consumption could harm the economy.	Less meat consumption could harm economy and cut jobs
reducing meat consumption would damage an important domestic industry.	Less meat consumption could harm economy and cut jobs
reducing meat consumption could hurt the economy and take away precious jobs.	Less meat consumption could harm economy and cut jobs
reducing this consumption could hurt the economy and take away jobs by disrupting the meat industry.	Less meat consumption could harm economy and cut jobs
reducing meat consumption could harm the economy.	Less meat consumption could harm economy and cut jobs
reducing meat consumption could hurt the economy.	Less meat consumption could harm economy and cut jobs
reducing meat consumption will hurt the domestic industry leading to hurting the economy an taking away jobs.	Less meat consumption could harm economy and cut jobs
largely reducing meat consumption would greatly hurt the U.S. economy.	Less meat consumption could harm economy and cut jobs
reducing meat consumption can hurt the economy and take away precious jobs.	Less meat consumption could harm economy and cut jobs
reducing consumption could take away precious jobs and hurt the economy	Less meat consumption could harm economy and cut jobs
reducing meat could damage  an important domestic industry.	Less meat consumption could harm economy and cut jobs
reducing meat consumption could damage the economy.	Less meat consumption could harm economy and cut jobs
reducing meat production in a thriving industry could hurt the economy and cause job losses.	Less meat consumption could harm economy and cut jobs
Reducing meat consumption could damage an important domestic industry, hurting the economy and taking away precious jobs.	Less meat consumption could harm economy and cut jobs
reducing meat consumption could damage an important domestic industry, hurt the economy, and take away jobs.	Less meat consumption could harm economy and cut jobs
Reducing meat consumption could damage an important domestic industry, hurting the economy and taking away precious jobs	Less meat consumption could harm economy and cut jobs
reducing meat consumption could damage an important domestic industry, hurting the economy and taking away jobs.	Less meat consumption could harm economy and cut jobs
reducing the meat industry could harm the economy taking away jobs.	Less meat consumption could harm economy and cut jobs
reducing it would hurt the economy and take away jobs.	Less meat consumption could harm economy and cut jobs
reducing meat consumption could damage an enormous industry and cost jobs.	Less meat consumption could harm economy and cut jobs
reducing it would hurt the economy.	Less meat consumption could harm economy and cut jobs
Reducing meat consumption could damage an important domestic industry, hurting the economy and taking away precious jobs	Less meat consumption could harm economy and cut jobs
reducing meat consumption could damage the meat industry, hurt the economy and take away precious jobs.	Less meat consumption could harm economy and cut jobs
reducing this will remove jobs.	Less meat consumption could harm economy and cut jobs
reducing consumption could damage and industry and hurt the economy with job loss.	Less meat consumption could harm economy and cut jobs
reducing it could harm the economy and take away vital jobs.	Less meat consumption could harm economy and cut jobs
reducing meat consumption could harm our economy.	Less meat consumption could harm economy and cut jobs
reducing meat consumption will hurt the economy and take away jobs.	Less meat consumption could harm economy and cut jobs
reducing consumption of meat could harm the  domestic industries and taking away responsible jobs.	Less meat consumption could harm economy and cut jobs
reducing the meat industry would hurt the economy and take away jobs.	Less meat consumption could harm economy and cut jobs
reducing the meat consumption could damage an the domestic industry by hurting the economy and taking away precious jobs.	Less meat consumption could harm economy and cut jobs
reducing meat consumption can damage an important domestic industry, hurting the economy.	Less meat consumption could harm economy and cut jobs
reducing the amount of meat consumption would hurt the economy.	Less meat consumption could harm economy and cut jobs
reducing the consumption harms the economy.	Less meat consumption could harm economy and cut jobs
reducing meat consumption can harm the economy.	Less meat consumption could harm economy and cut jobs
reducing its harm is not an all-or-nothing choice because flexitarianism is an option.	Flexitarians benefit environment
reducing meat consumption could damage an important industry, hurting the economy and taking away precious jobs.	Less meat consumption could harm economy and cut jobs
reducing the amount of meat consumed could damage and alter the economy drastically.	Less meat consumption could harm economy and cut jobs
reducing consumption could harm the economy and eliminate jobs.	Less meat consumption could harm economy and cut jobs
reducing meat consumption could hurt the economy and taking away jobs.	Less meat consumption could harm economy and cut jobs
reducing meat consumption can hurt the economy.	Less meat consumption could harm economy and cut jobs
reducing consumption could harm the domestic industry and cost people their jobs.	Less meat consumption could harm economy and cut jobs
reducing meat consumption could damage global and domestic economies.	Less meat consumption could harm economy and cut jobs
reducing meat consumption could damage an important domestic industry, hurting the economy and taking away precious jobs.	Less meat consumption could harm economy and cut jobs
reducing meat consumption could damage the meat industry, hurting the economy and taking away jobs.	Less meat consumption could harm economy and cut jobs
reducing consumption could take away jobs and hurt the economy.	Less meat consumption could harm economy and cut jobs
reducing consumption could be a detriment to the economy due to eliminated jobs and damage to the domestic industry.	Less meat consumption could harm economy and cut jobs
reducing our meat intake domestically could result in less jobs for those in the industry, as well as potentially negative feelings for those Americans who feel meat is part of their cultural identity.	Less meat consumption could harm economy and cut jobs
reducing meat consumption could have a strong negative effect on an important industry in America, reducing jobs and hurting the economy.	Less meat consumption could harm economy and cut jobs
reducing meat consumption could damage an important  domestic industry, hurting the economy and taking away precious jobs.	Less meat consumption could harm economy and cut jobs
reducing meat consumption could harm peoples' livelihood.	Less meat consumption could harm economy and cut jobs
reducing meat consumption could damaged the economy and take away jobs.	Less meat consumption could harm economy and cut jobs
reducing meat consumption could damage an important an important domestic industry.	Less meat consumption could harm economy and cut jobs
reducing meat consumption could damage an important  industry, hurting the economy and losing  jobs.	Less meat consumption could harm economy and cut jobs
reducing meat consumption could damage an important domestic industry, hurting the economy and taking away jobs.	Less meat consumption could harm economy and cut jobs
reducing meat consumption could damage the economy.	Less meat consumption could harm economy and cut jobs
reducing meat consumption could take away jobs and hurt the economy.	Less meat consumption could harm economy and cut jobs
reducing meat consumption could hurt the economy and jobs since meat exportation is such a big part of the economy.	Less meat consumption could harm economy and cut jobs
reducing meat consumption could harm the industry and remove jobs and hurt the economy.	Less meat consumption could harm economy and cut jobs
reducing meat consumption can take away jobs and hurt the economy.	Less meat consumption could harm economy and cut jobs
by reducing the consumption and thus the demand, greenhouse gases related to the meat industry could be lowered to be less than one-fifth of all greenhouse gasses.	Flexitarians benefit environment
reducing consumption could hurt the economy and take away jobs.	Less meat consumption could harm economy and cut jobs
reducing the consumption of meat could harm an important domestic industry and hurt the economy.	Less meat consumption could harm economy and cut jobs
reducing meat consumption could be damaging to an important domestic industry, hurting the economy and taking away precious jobs.	Less meat consumption could harm economy and cut jobs
reducing the consumption of meat would harm the economy and cause an increase in unemployment	Less meat consumption could harm economy and cut jobs
reducing meat consumption could damage an important domestic industry, because more countries are starting to integrate meat into their daily lives.	Less meat consumption could harm economy and cut jobs
reducing meat consumption could harm the thriving meat industry, which would hurt our economy and take away jobs.	Less meat consumption could harm economy and cut jobs
reducing  meat consumption could damage an important domestic industry, hurting the economy and taking away jobs.	Less meat consumption could harm economy and cut jobs
reducing meat consumption could damage the important domestic meat industry, which in turn would hurt the economy and take away precious jobs.	Less meat consumption could harm economy and cut jobs
reducing meat consumption could harm the economy it would reduce jobs.	Less meat consumption could harm economy and cut jobs
reducing meat consumption could damage an important domestic industry, hurting the economy, and taking away precious jobs.	Less meat consumption could harm economy and cut jobs
reducing meat consumption could result in a lot of people losing their jobs.	Less meat consumption could harm economy and cut jobs
Reducing meat consumption could damage an important domestic industry, hurting the economy and taking away precious jobs.	Less meat consumption could harm economy and cut jobs
reducing meat consumption could harm a thriving meat industry.	Less meat consumption could harm economy and cut jobs
reducing meat consumption could take away jobs.	Less meat consumption could harm economy and cut jobs
reducing meat production will hurt us economically because it is one of the major American domestic industries.	Less meat consumption could harm economy and cut jobs
reducing consumption could hurt a very important domestic industry.	Less meat consumption could harm economy and cut jobs
reducing meat consumption could damage the economy and take away jobs.	Less meat consumption could harm economy and cut jobs
reducing meat consumption hurt the economy and take away jobs.	Less meat consumption could harm economy and cut jobs
reducing meat consumption would destroy an important US industry.	Less meat consumption could harm economy and cut jobs
reducing consumption could hurt the economy and take away precious jobs.	Less meat consumption could harm economy and cut jobs
reducing meat consumption could help in regards to this.	Less meat consumption could harm economy and cut jobs
reducing meat consumption would damage an important industry, hurt the economy, and take away jobs.	Less meat consumption could harm economy and cut jobs
reducing meat consumption considerably could damage an important domestic industry and damage the economy.	Less meat consumption could harm economy and cut jobs
reducing intake would harm the economy.	Less meat consumption could harm economy and cut jobs
reducing meat consumption could harm the U.S. domestic industry, negatively impact the economy and cause the loss of jobs.	Less meat consumption could harm economy and cut jobs
reducing meat consumption could damage an important domestic industry, thus hurting the economy.	Less meat consumption could harm economy and cut jobs
reducing the meat industry could hurt the economy.	Less meat consumption could harm economy and cut jobs
reducing meat consumption can hurt the economy.	Less meat consumption could harm economy and cut jobs
reducing the market for meat consumption would take away jobs and harm the economy.	Less meat consumption could harm economy and cut jobs
reducing meat consumption could harm several of key American economic industries.	Less meat consumption could harm economy and cut jobs
reducing or stopping meat consumption will have an adverse effect on economies and jobs.	Less meat consumption could harm economy and cut jobs
reducing the amount of meat that we eat could harm the economy.	Less meat consumption could harm economy and cut jobs
reducing meat consumption would be very harmful to the American economy.	Less meat consumption could harm economy and cut jobs
reducing the amout of meat you consume, or choosing alternatives can have a positive impact	Flexitarians benefit environment
redusing meat consumption would cause damage to important domestic industry, hurt the economy, and reduce much needed jobs.	Less meat consumption could harm economy and cut jobs
refusing meat consumption could hurt a major industry to the American economy and therefor jobs could be lost.	Less meat consumption could harm economy and cut jobs
jobs related to meat are a significant source of domestic employment in the United States.	Meat creates jobs and benefits economy
jobs relating to the meat industry drastically boost the economy as a whole.	Meat creates jobs and benefits economy
still remain a large and growing part of many cultures' diets around the world	Eating meat is part of culture/tradition
removing meat consumption will take away a thriving export market and take away jobs.	Less meat consumption could harm economy and cut jobs
removing meat entirely could harm an important economic sector.	Less meat consumption could harm economy and cut jobs
removing it entirely would also greatly damage local economy.	Less meat consumption could harm economy and cut jobs
the loss of jobs from the livestock production sector which could result as a reduction/elimination of meat consumption, might result in a major economic crisis.	Less meat consumption could harm economy and cut jobs
rting the economy and taking away precious jobs	Less meat consumption could harm economy and cut jobs
it's hard to do anything about it because meat consumption is a large part of American culture and is quickly becoming a part of cultures around the world.	Eating meat is part of culture/tradition
it's still possible to consume meat in moderation	Flexitarian w/o connection to environment or jobs
it's a classic American food.	Flexitarian w/o connection to environment or jobs
it's an important domestic industry.	The meat industry is important/thriving and/or exports/demand increasing
it's traditional to eat meat so we should keep doing it.	Eating meat is part of culture/tradition
there's ways to cut down on this issue.	Change without mentioning consumption
it's an important part of the american way.	Eating meat is part of culture/tradition
small farms can save the environment	Outside of article's scope
In my point of view i will say strongly  that cow should not be killed for eating purposes.	Outside of article's scope
in my point of view i will say strongly that we should not kill the cow and eat.	Outside of article's scope
many people see eating meat as an integral part of their culture heritage.	Eating meat is part of culture/tradition
we ship a lot of meats to other countries for consumption, so we're profitable.	The meat industry is important/thriving and/or exports/demand increasing
it doesnt show.	Outside of article's scope
slowing down or stopping would hurt the meat market and national economy.	Less meat consumption could harm economy and cut jobs
stated claim	Outside of article's scope
the stated claim	Outside of article's scope
if everyone stopped eating meat it could have a large impact on our economy as many people would lose their jobs.	Less meat consumption could harm economy and cut jobs
if we stopped consuming it entirely, there would be many jobs lost and the economy would suffer.	Less meat consumption could harm economy and cut jobs
stopping this would cause great problem in the enconomy and loss of jobs.	Less meat consumption could harm economy and cut jobs
stopping this could hurt the economy taking away jobs.	Less meat consumption could harm economy and cut jobs
unilaterally stopping eating meat, can also hurt the economy.	Less meat consumption could harm economy and cut jobs
by stopping meat consumption you could damage the economy and cost people their jobs.	Less meat consumption could harm economy and cut jobs
not supporting the meat industry could seriously harm our economy	Less meat consumption could harm economy and cut jobs
also supporting the economy and providing jobs.	Meat creates jobs and benefits economy
it also supports many jobs	Meat creates jobs and benefits economy
the meat industry supports many many precious jobs.	Meat creates jobs and benefits economy
the meat industry supports the economy and workers.	Meat creates jobs and benefits economy
people need the iron in meat to survive.	Eating meat is necessary for good nutrition
people can switch to mostly plant based diets and eliminate some of that damage.	Flexitarians benefit environment
could take away jobs	Less meat consumption could harm economy and cut jobs
if taken away could hurt the economy  and take away jobs	Less meat consumption could harm economy and cut jobs
taking away meat is taking away the American culture and its traditions.	Eating meat is part of culture/tradition
taking away the meat industry would be damaging to the economy and the job market.	Less meat consumption could harm economy and cut jobs
taking away meat would be taking away important cultural practices of Americans.	Less meat consumption could harm economy and cut jobs
however taking away the meat industry could effect the economy in major ways.	Less meat consumption could harm economy and cut jobs
taking away the meat industry would reduce jobs and hurt the economy.	Less meat consumption could harm economy and cut jobs
taking meat away could be bad for the economy and cut a large number of jobs.	Less meat consumption could harm economy and cut jobs
taking away jobs	Less meat consumption could harm economy and cut jobs
taking action against the meat industry could potentially harm one of the largest economic pillars of our society.	Less meat consumption could harm economy and cut jobs
taste good	People will or should still eat meat
it still tastes great.	People will or should still eat meat
it tastes great and a huge part of being an American.	Eating meat is part of culture/tradition
it tastes so good to so many people.	People will or should still eat meat
people still tend to eat it due to holidays and it being a part of their diets.	Eating meat is part of culture/tradition
if you took away eating meat, it would harm an industry and take away jobs from people.	Less meat consumption could harm economy and cut jobs
transitioning the american population away from meat consumption could prove to be incredibly difficult as any public policy proposal could be seen as an infringement on individual liberties and as such be a potentially toxic issue	Outside of article's scope
large, concentrated crop farms also use lots of water and harm the environment.	Meat consumption harms environment
sometimes the environment could use the space	Outside of article's scope
almost half the water used in the US goes to raising livestock.	Meat consumption harms environment
almost half of the water used in the U.S. goes to raising livestock.	Meat consumption harms environment
much of the land used to raise cattle also support a diverse biome that would be destroyed if the land would be taken over by monoculture farming to support vegetarian lifestyles.	Outside of article's scope
if we used locally produced meat products the gases produced in the transportation of meat would be greatly reduced	Outside of article's scope
it uses water.	Meat consumption harms environment
using the flexitarian approach can offset some of the harm.	Flexitarians benefit environment
Americans view meat eating as part of a cultural expression and tradition.	Eating meat is part of culture/tradition
many people view meat as an essential part of their diet, and it is an important and profitable industry in America.	The meat industry is important/thriving and/or exports/demand increasing
we don't want to lose jobs.	Less meat consumption could harm economy and cut jobs
not as much as alarmist wants you to think.	Outside of article's scope
it was always like that	Eating meat is part of culture/tradition
it was really not bad	Outside of article's scope
Eating meat was and for some is still a way of survival.	People will or should still eat meat
if people were to lower their consumption of meat it will affect economy by taking away jobs of people who work on raising animals and meat transportation jobs	Less meat consumption could harm economy and cut jobs
I do not like vegetables so I will continue to eat meat.	People will or should still eat meat
its good for our domestic economy.	Meat creates jobs and benefits economy
I still want to eat meat	People will or should still eat meat
the domestic industry thrives from it.	The meat industry is important/thriving and/or exports/demand increasing
we need it for jobs.	Meat creates jobs and benefits economy
to much pollution	Meat consumption harms environment
people does it anyways.	People will or should still eat meat
I love meat	People will or should still eat meat
environmental effects	Meat consumption harms environment
most humans need that source of protein.	Eating meat is necessary for good nutrition
vv	Outside of article's scope
good for the economy.	Meat creates jobs and benefits economy
x	Outside of article's scope
some people consume meat and fish only occasionally and in moderation	Flexitarian w/o connection to environment or jobs
there	Outside of article's scope
some people try to have a stricter diet with eating meat.	Flexitarian w/o connection to environment or jobs
its also a healthy and responsible choice	Eating meat is necessary for good nutrition
other areas of resource use account for 80% of greenhouse gas emission.	Outside of article's scope
dhdhshshsbsbsbs	Outside of article's scope
its a essential part of our culture.	Eating meat is part of culture/tradition
