but allow them to take it with them to school if they so wish	School without generating money
but should allow sweets for special occasions	School without generating money
but they should allow kids to bring their own snacks including junk food	School without generating money
but here schools are, still selling this junk food that only promotes poor eating habits which could lead to a lot of health complications	School without generating money
but there are plenty of other foods schools can sell for fundraising such as popcorn	School without generating money
but should not ban it	School without generating money
but they should not ban candy companies from advertising in schools if it provides funding	School without generating money
but there could be special events monthly where parents are advised that there will be treats sold for a fundraiser or other school event	School without generating money
but they should be allowed other means to replace the revenue lost by disallowing junk food sales	School without generating money
but they should be allowed to make an exception for after school events such as football games	School without generating money
but they should be prepared for community backlash	School without generating money
but if they do they should charge more for it	School without generating money
but they continue to do so	School without generating money
but they probably will continue to do so	School without generating money
but they will continue to do it anyway	School without generating money
but they should not control their diet outside of school	School without generating money
but they did not take step to stop selling	School without generating money
but schools could fill snack machines with more nutritious options	School without generating money
but Some school has been sold this foods	School without generating money
but schools already have so many roles to fill that asking them to arbitors of health may be too much to ask	School without generating money
but they have no control over what foods their students eat away from school	School without generating money
but they have to get an incentive to stop offering it	School without generating money
but they could just have a small amount of it instead of the amount they have been selling at	School without generating money
but they do not have the right to police food brought in from the outside	School without generating money
but they should have greater accessibility to nutrient dense foods	School without generating money
but they should have options for teachers and other staff	School without generating money
but they should also incorporate greater amounts of exercise into the school day	School without generating money
but they should not interfere with what students bring for lunch from home	School without generating money
but it is up to the discretion of each school or the school board	School without generating money
but they do anyways because ultimately it is a person's choice to eat healthy or not	School without generating money
but if htey do, limit it to after school	School without generating money
but schools make a sizable profit by selling junk food items in vending machines	School without generating money
but teens can make decisions about what they eat when they are not at school	School without generating money
but the schools can make some revenue for school improvements by selling junk food	School without generating money
but they should make snacks available that are more appetizing to students and more filling to the body than, say, an apple	School without generating money
but they could offer the option to buy snacks once a week	School without generating money
but they should not prevent it being brought from home	School without generating money
but it's up to the individual campuses to decide	School without generating money
but many schools do it because they do not see it as their job to change the diet of their students	School without generating money
but should also teach nutrition	School without generating money
but they should teach how to incorporate small amount of these food into diet for enjoyment	School without generating money
but they tried to give us a choice between food	School without generating money
but they do	School without generating money
but they should options for teachers	School without generating money
but they will anyway	School without generating money
but they shouldn't advertise not eating junk food off of campus or from another location	School without generating money
but shouldnâ€™t confiscate junk food that is brought from home	School without generating money
but they cannot enforce eating habits outside of school	School without generating money
but should eschew the misnamed pseudoscience about "healthiness" of foods, instead emphasizing nutrition as understood scientifically	School without generating money
but should instead have a less-healthy option available once a week, on Fridays to keep things more fun and teach balance	School without generating money
but it is not possible to control their eating habits off-campus	School without generating money
but they cannot preach about it, just do what they can by not allowing the vending machines in their schools	School without generating money
but it would be ok once in a while	Schools generate money
but they would be losing a good revenue source	Schools generate money
but it brings in income for the school	Schools generate money
but continue to so they make more money	Schools generate money
but schools continue to do so because of the revenue it brings	Schools generate money
but this practice will continue since they are making money	Schools generate money
but doing so would cause them to lose money that could be used to provide key funding	Schools generate money
but they earn money with junk food	Schools generate money
but the sale of junk food can generate a significant amount of profit	Schools generate money
but it does generate money	Schools generate money
but it does generate more money for schools because students are more likely to purchase junk food	Schools generate money
but it generates income for schools	Schools generate money
but it generates money for schools	Schools generate money
but it generates revenue for the schools	Schools generate money
but selling snacks also generates money for schools	Schools generate money
but it does help the school make money	Schools generate money
but they still do because it is used as a tool to raise money	Schools generate money
but the profit they make from it is tempting	Schools generate money
but the schools make money off of it	Schools generate money
but they make money selling junk food	Schools generate money
but they do because they make money off it	Schools generate money
but they do to make some extra money	Schools generate money
but it does provide the school system with extra revenue	Schools generate money
but it does raise money for schools	Schools generate money
but selling snacks does raise money for the school	Schools generate money
but it's almost impossible to forget the profits the schools make when selling these products	Schools generate money
but selling junk foods generates money for the school	Schools generate money
but I do not think that schools will totally eliminate junk food on campus because it generates much needed money for them	Schools generate money
but add it with sweet things but sweet things that are good for you	Schools providing healthy alternatives
but allow healthier alternative so children could choose from	Schools providing healthy alternatives
but allow healthier snacks	Schools providing healthy alternatives
but allow healthy foods like vegetables and Protein bars	Schools providing healthy alternatives
but allow many some kind of healthy snacks instead	Schools providing healthy alternatives
but allow more healthy snacks and food	Schools providing healthy alternatives
but instead allow the sale of more healthful food options in order to promote good health and healthy personal habits	Schools providing healthy alternatives
but the school allow snack machines with more nutritious foods	Schools providing healthy alternatives
but it can allow to sell healthy snack and nutritious food	Schools providing healthy alternatives
but it can allow to sell nutritious foods	Schools providing healthy alternatives
but they could allow healthier alternatives	Schools providing healthy alternatives
but instead should allow healthier options to be sold on campus	Schools providing healthy alternatives
but should allow for healthy food to be available	Schools providing healthy alternatives
but should allow healthy food	Schools providing healthy alternatives
but should allow nutritious food to be sold	Schools providing healthy alternatives
but should instead allow healthy food to be sold on campus	Schools providing healthy alternatives
but they should allow healthy snack alternatives to be sold	Schools providing healthy alternatives
but they should allow students to purchase healthier snack options	Schools providing healthy alternatives
but allowed to bring healthier food to the school	Schools providing healthy alternatives
but healthy foods only allowed for students	Schools providing healthy alternatives
but certain snacks are alright	Schools providing healthy alternatives
but if they are going to, they should put healthier junk food snacks in the vending machines for purchase	Schools providing healthy alternatives
but only if there are more nutritional foods being offered to the students so that they can make a healthy choice decision	Schools providing healthy alternatives
but be allowed to sell healthier alternative snacks and food	Schools providing healthy alternatives
but healthier alternatives can be made available to the students	Schools providing healthy alternatives
but it can be easily replaced with good food	Schools providing healthy alternatives
but other healthy food can be allowed	Schools providing healthy alternatives
but they can be selling healthy food instead	Schools providing healthy alternatives
but there could be healthy alternatives	Schools providing healthy alternatives
but it may be possible to offer healthier snack choices instead of junk food	Schools providing healthy alternatives
but serious consideration must be made in choosing replacements for it	Schools providing healthy alternatives
but children need to be exposed to healthy eating	Schools providing healthy alternatives
but a slight compromise should be sought to make everyone happy	Schools providing healthy alternatives
but an alternative should be offered as children need nutrition	Schools providing healthy alternatives
but healthier alternatives should be provided	Schools providing healthy alternatives
but healthy options should be offered	Schools providing healthy alternatives
but healthy snacks like low sugar yogurt and fruit SHOULD be sold	Schools providing healthy alternatives
but healthy snacks should be	Schools providing healthy alternatives
but healthy snacks should be added to school vending machines as part of an initiative aimed at changing kids' eating and fitness habits	Schools providing healthy alternatives
but instead healthier options should be made available	Schools providing healthy alternatives
but instead should be able to make up the revenue with healthier snack options, as students will gravitate towards these options when less healthy snacks are unavailable	Schools providing healthy alternatives
but nutritious food and snacks should be sold instead	Schools providing healthy alternatives
but only healthy foods should be sold	Schools providing healthy alternatives
but other more healthy alternatives should be sold	Schools providing healthy alternatives
but should be allowed to sell snacks and soda	Schools providing healthy alternatives
but should be allowed to sell somewhat healthier alternatives	Schools providing healthy alternatives
but there should be alternatives they sell	Schools providing healthy alternatives
but there should be healthy snacks available	Schools providing healthy alternatives
but they should be allowed to provide healthy snacks and drinks for students to enjoy	Schools providing healthy alternatives
but they should be offering healthy snacks	Schools providing healthy alternatives
but I believe that some junk food is okay, it's just about moderation and balancing it out with more healthy foods	Schools providing healthy alternatives
but Bring healthy food	Schools providing healthy alternatives
but instead they should bring some healthy snacks and foods	Schools providing healthy alternatives
but they can choose to sell food that are nutritious and healthy	Schools providing healthy alternatives
but they may consider replacing the snacks with healthy options	Schools providing healthy alternatives
but should consider allowing healthy options to be sold	Schools providing healthy alternatives
but they need to eat healthy	Schools providing healthy alternatives
but should encourage healthier eating habits by providing alternative snacks and beverages	Schools providing healthy alternatives
but instead fill snack machines with nutritious foods	Schools providing healthy alternatives
but could fill the snack machines with more nutritious food	Schools providing healthy alternatives
but schools could fill snack machines with more nutritious foods	Schools providing healthy alternatives
but schools could fill the snack machines with healthy choices	Schools providing healthy alternatives
but the schools could fill snack machines with more nutritious foods	Schools providing healthy alternatives
but they could fill snack machines with more nutritious foods	Schools providing healthy alternatives
but they must fill snack machines with more nutritious food	Schools providing healthy alternatives
but need to find attractive food alternatives that interest students	Schools providing healthy alternatives
but should instead focus on providing nutritious alternatives such as fruits like apples, bananas and other healthy choices	Schools providing healthy alternatives
but give alternate snacks that are healthier	Schools providing healthy alternatives
but have a variety of options for the kids to choose from	Schools providing healthy alternatives
but have healthier choices for students to choose from either cafeteria or vending machines if there are any	Schools providing healthy alternatives
but have healthy options	Schools providing healthy alternatives
but CAN HAVE CHEESES	Schools providing healthy alternatives
but can have more variety of healthy food	Schools providing healthy alternatives
but it should have healthy snacks instead like dried fruits and nuts and nut alternatives for the allergic	Schools providing healthy alternatives
but should have alternative healthy snacks available	Schools providing healthy alternatives
but should have snacks that are healthy alternatives as treats	Schools providing healthy alternatives
but should have vending machines that have healthy snack options	Schools providing healthy alternatives
but they should at have least allow children to choose between healthy food and snacks	Schools providing healthy alternatives
but they should have healthy alternatives for the kids to turn too when they do want a snack	Schools providing healthy alternatives
but they should have healthy snacks	Schools providing healthy alternatives
but they should have other options available	Schools providing healthy alternatives
but they should have some healthy foods that still take good, liked baked potato chips instead of fried	Schools providing healthy alternatives
but they should having vending machines that sell healthy options	Schools providing healthy alternatives
but they should incorporate healthier and more nutritious foods	Schools providing healthy alternatives
but they should incorporate healthy initiatives	Schools providing healthy alternatives
but they should incorporate healthy snacks in the vending machines	Schools providing healthy alternatives
but if they insist it could be healthy options	Schools providing healthy alternatives
but they can slowly integrate healthier choices such as baked potato chips instead of fried	Schools providing healthy alternatives
but if it is allowed, healthier choices should also be allowed as well	Schools providing healthy alternatives
but if it is available they should also have healthy choices as well	Schools providing healthy alternatives
but if it is sold at schools, then it should be low fat items like low fat chips and sugar free items	Schools providing healthy alternatives
but in some cases junk food is less expensive than healthier options so junk is perhaps all some can afford	Schools providing healthy alternatives
but it is a difficult problem to solve as healthy food tends to be much more expensive	Schools providing healthy alternatives
but it is also our responsibility as parents to teach healthy eating habits	Schools providing healthy alternatives
but it is good to have a balance of healthy and junk food	Schools providing healthy alternatives
but I like the idea of health alternatives being put in the snack machines so they can still have snack throughout the day	Schools providing healthy alternatives
but instead make healthy choices available	Schools providing healthy alternatives
but make snack machines with more nutritious foods	Schools providing healthy alternatives
but make the food less sugary and salty to make it healthy	Schools providing healthy alternatives
but they should make healthier snacks available	Schools providing healthy alternatives
but they should make sure the healthier options are things kids will actually enjoy	Schools providing healthy alternatives
but they should make sure there are healthy options for snacks to replace the junk food	Schools providing healthy alternatives
but a couple random snacks mixed in as a treat every once in awhile is alright as well	Schools providing healthy alternatives
but instead offer healthier options to students for purchase	Schools providing healthy alternatives
but instead offer healthy alternatives	Schools providing healthy alternatives
but instead offer healthy snacks	Schools providing healthy alternatives
but offer a more nutritious alternative	Schools providing healthy alternatives
but offer alternative snack optoins	Schools providing healthy alternatives
but offer different alternatives	Schools providing healthy alternatives
but offer healthier alternatives	Schools providing healthy alternatives
but offer healthy alternatives	Schools providing healthy alternatives
but offer healthy alternatives	Schools providing healthy alternatives
but offer healthy snacks	Schools providing healthy alternatives
but offer instead some different options, maybe they could sell healthy granola bars instead	Schools providing healthy alternatives
but can offer healthier options	Schools providing healthy alternatives
but can offer healthy food choices in vending machines	Schools providing healthy alternatives
but if they must they can offer healthy alternatives	Schools providing healthy alternatives
but they can offer nutritious foods	Schools providing healthy alternatives
but could offer alternative healthy foods in their place	Schools providing healthy alternatives
but they could offer healthy and delicious food choices that contain fruits, vegetables, healthy grains, and the like, plus information about how to make good food choices	Schools providing healthy alternatives
but they could offer healthy options in place of junk food	Schools providing healthy alternatives
but they could offer some snack foods that are low in calories or not as salty or sugary but to be able to still give them a choice	Schools providing healthy alternatives
but they may offer more choices of healthy food	Schools providing healthy alternatives
but they need to offer affordable healthy options in place of the junk food, not sell healthy stuff for a marked up, outrageous price	Schools providing healthy alternatives
but instead, should offer tasty and nutritious snack options	Schools providing healthy alternatives
but instead should offer a wider variety of healthier snacks, so there is something for all students to enjoy	Schools providing healthy alternatives
but instead should offer healthy options	Schools providing healthy alternatives
but instead should offer more healthy alternatives, which taste good as well	Schools providing healthy alternatives
but should instead offer healthier options	Schools providing healthy alternatives
but should instead offer healthy snack options	Schools providing healthy alternatives
but should instead should offer healthy alternatives such as fruits and veggies to children	Schools providing healthy alternatives
but should offer better choices	Schools providing healthy alternatives
but should offer healthy alternative snacks	Schools providing healthy alternatives
but should offer healthy alternative snacks to purchase	Schools providing healthy alternatives
but should offer healthy alternatives instead	Schools providing healthy alternatives
but should offer healthy alternatives like fruit	Schools providing healthy alternatives
but should offer healthy alternatives that taste similar to the junk food	Schools providing healthy alternatives
but should offer healthy alternatives to junk food	Schools providing healthy alternatives
but should offer healthy alternatives to promote healthy habits	Schools providing healthy alternatives
but should offer healthy food choices in vending machines	Schools providing healthy alternatives
but should offer healthy food instead	Schools providing healthy alternatives
but should offer healthy sweet alternatives such as fruit or spreads	Schools providing healthy alternatives
but should offer many options for students which would be a healthier alternative	Schools providing healthy alternatives
but should offer other alternatives	Schools providing healthy alternatives
but should offer reasonable alternative to the type of snacks that you would expect to find at a school	Schools providing healthy alternatives
but should offer students healthier options in their vending machines	Schools providing healthy alternatives
but they should definitely offer healthy snack options	Schools providing healthy alternatives
but they should offer a healthy alternative	Schools providing healthy alternatives
but they should offer a wide variety of healthy alternatives	Schools providing healthy alternatives
but they should offer healthier alternatives and work with health professionals to help create healthy eating initiatives	Schools providing healthy alternatives
but they should offer healthy alternatives	Schools providing healthy alternatives
but they should offer healthy alternatives and encourage children to make better decisions	Schools providing healthy alternatives
but they should offer healthy alternatives that are appealing to kids	Schools providing healthy alternatives
but they should offer tasty alternatives that are healthy	Schools providing healthy alternatives
but promote healthier alternatives	Schools providing healthy alternatives
but promote healthy habits	Schools providing healthy alternatives
but should instead promote healthy eating by filling snack machines with nutritious foods	Schools providing healthy alternatives
but should instead promote healthy eating options	Schools providing healthy alternatives
but provide a healthy alternative to sugary snack foods	Schools providing healthy alternatives
but provide alternative healthy snacks	Schools providing healthy alternatives
but provide alternatives to junk food that are just as tasty	Schools providing healthy alternatives
but provide healthy alternatives instead	Schools providing healthy alternatives
but provide healthy options	Schools providing healthy alternatives
but provide healthy snack foods instead	Schools providing healthy alternatives
but provide healthy snacks instead	Schools providing healthy alternatives
but provide public health education of its dangers	Schools providing healthy alternatives
but they could provide healthier versions which would provide additional funding for the schools	Schools providing healthy alternatives
but they need to provide healthy alternatives so that students still have a wide freedom of choice for their potential food options	Schools providing healthy alternatives
but instead should provide healthier food alternatives	Schools providing healthy alternatives
but should instead provide healthy alternatives	Schools providing healthy alternatives
but should provide a wider range of healthier options	Schools providing healthy alternatives
but should provide access to healthy snacks	Schools providing healthy alternatives
but should provide health alternatives	Schools providing healthy alternatives
but should provide healthier choices	Schools providing healthy alternatives
but should provide healthier snacks for students to have	Schools providing healthy alternatives
but should provide healthy, nutritious food instead	Schools providing healthy alternatives
but should provide healthy options for snacks	Schools providing healthy alternatives
but should provide healthy snacks instead to raise revenue	Schools providing healthy alternatives
but should provide other nutritious food for students	Schools providing healthy alternatives
but should provide some option of snack for them	Schools providing healthy alternatives
but they should provide a healthier alternative,	Schools providing healthy alternatives
but they should provide a variety of healthy foods to students	Schools providing healthy alternatives
but they should provide a variety of healthy options	Schools providing healthy alternatives
but they should provide alternative food that is kids friendly and nutritious	Schools providing healthy alternatives
but they should provide healthy options	Schools providing healthy alternatives
but they should provide healthy options	Schools providing healthy alternatives
but they should provide healthy snacks for students to choose	Schools providing healthy alternatives
but they should provide more healthy alternatives to such food	Schools providing healthy alternatives
but should provided healthy alternatives	Schools providing healthy alternatives
but so that children receive a better health message and have better food options	Schools providing healthy alternatives
but replace it junk food with healthier options	Schools providing healthy alternatives
but replace them with healthy and nutritious options	Schools providing healthy alternatives
but they can replace the junk food with some nutritious foods	Schools providing healthy alternatives
but they can replace them with healthy snacks instead	Schools providing healthy alternatives
but should instead replace it with healthy alternatives	Schools providing healthy alternatives
but should instead replace junk food with healthier food options such as fruit and cut up veggie snacks	Schools providing healthy alternatives
but should replace junk food with more nutritious snack options	Schools providing healthy alternatives
but they can replaced the junk foods by selling some nutritional foods	Schools providing healthy alternatives
but if they sell healthy food more students will concentrate better	Schools providing healthy alternatives
but instead sell fruit as a substitute	Schools providing healthy alternatives
but sell nutritious foods	Schools providing healthy alternatives
but they sell an good items	Schools providing healthy alternatives
but Can sell healthier options	Schools providing healthy alternatives
but they can sell healthy snacks	Schools providing healthy alternatives
but they can sell more nutritious foods	Schools providing healthy alternatives
but they could sell a variety of healthy snacks	Schools providing healthy alternatives
but they could sell healthy options elsewhere	Schools providing healthy alternatives
but they could sell healthy snacks	Schools providing healthy alternatives
but they could sell healthy snacks	Schools providing healthy alternatives
but they could sell similar good tasting healthier options	Schools providing healthy alternatives
but they could still sell healthy snacks	Schools providing healthy alternatives
but should instead sell healthy foods	Schools providing healthy alternatives
but should sell healthy alternatives	Schools providing healthy alternatives
but should sell more nutritional options of food	Schools providing healthy alternatives
but should sell more nutritious foods because they have great nutritional value	Schools providing healthy alternatives
but they should sell healthier snacks	Schools providing healthy alternatives
but they should sell healthy food options	Schools providing healthy alternatives
but they should sell healthy options	Schools providing healthy alternatives
but they should sell more nutritious snacks	Schools providing healthy alternatives
but they should also serve more healthy and nutritious lunches to students as well	Schools providing healthy alternatives
but they could stock vending machines with healthier food	Schools providing healthy alternatives
but they should stock the cafeteria and machines with healthier snack options to provide food for the kids and generate income for the school	Schools providing healthy alternatives
but should instead substitute healthier foods in the vending machines	Schools providing healthy alternatives
but take into account student feedback on they types of healthy foods to include	Schools providing healthy alternatives
but they should teach students accurate health information	Schools providing healthy alternatives
but I think that giving the kids healthy choices would be a great replacement	Schools providing healthy alternatives
but I think that we can still make money for the schools by allowing healthy snack options to be placed in vending machines	Schools providing healthy alternatives
but I think they should sell other healthy snacks	Schools providing healthy alternatives
but should try to maintain healthy eating habits and lifestyle for the student while they attend the school	Schools providing healthy alternatives
but should try to provide alternatives to junk food that can be sold on campus	Schools providing healthy alternatives
but they might want to allow for a larger range of healthy snacks to be made available to students	Schools providing healthy alternatives
but schools can work with their food service providers to offer healthy versions of students' favorite foods	Schools providing healthy alternatives
but apples and fruit should	Schools providing healthy alternatives
but BUT HEALTHY SNACKS	Schools providing healthy alternatives
but educate kids about healthy eating	Schools providing healthy alternatives
but fruits	Schools providing healthy alternatives
but healthier alternatives	Schools providing healthy alternatives
but if its a healthy junk food its okay	Schools providing healthy alternatives
but SHOULD PROMOTE HEALTHY SNACKS	Schools providing healthy alternatives
but should also be limited on what quasi-healthy options are available as well (eg	Schools providing healthy alternatives
but it doesn't mean they can't keep selling snacks and food, there are many healthy alternatives to basically every single type of food these days	Schools providing healthy alternatives
but could offer some snacks that are but also some that arent	Schools providing healthy alternatives
but they should provide healthy and good-tasting alternatives so students do not feel deprived at school	Schools providing healthy alternatives
but they should stack the snack machines with just a few junk food and 98% of the snacks should be healthy choices	Schools providing healthy alternatives
but if there was a program to allow children the healthy and inherently more expensive food at a more affordable price, then thats a different story	Schools providing healthy alternatives
but it does allow students to make choices	Student choice
but some argue that students should be allowed to choose what they eat	Student choice
but children should be allowed to chose what they eat	Student choice
but it should be the child's choice of what they eat	Student choice
but kids should be able to choose	Student choice
but people should be allowed to choose their own diet	Student choice
but students should be able to make their own decisions about what foods they consume	Student choice
but students should be allowed to choose what they eat	Student choice
but students should be responsible enough to make healthy choices on their own	Student choice
but young people should be given the choice of what types of items they would like to purchase and eat	Student choice
but its still their own choice what they decide to do	Student choice
but the choice to eat healthy or unhealthy is ultimately up to the student	Student choice
but many people feel that it raises money for the school and gives kids a choice of what they should eat	Student choice
but we give kids the choices of what to eat	Student choice
but students have a choice about what they eat	Student choice
but children should have a choice about what to eat	Student choice
but kids really should have a choice as to what they want to eat	Student choice
but kids should have a choice within the limits of what is healthy	Student choice
but students should have a choice about what they eat	Student choice
but students should have a choice about what they eat	Student choice
but students should have a choice in what they eat	Student choice
but that interferes with freedom of choice	Student choice
but it is important for students to be able to make their own choices	Student choice
but there is an argument to be made that students should be allowed to make their own food choices	Student choice
but should respect students' right of free choice	Student choice
but at the end of the day, it's the students choice	Student choice
but some say students should be able to make their own choices of what to eat	Student choice
but I can see how the schools want to give the kids a choice	Student choice
but some people think students should be able to choose what they eat	Student choice
but some people think the kids should be able to make their own choices	Student choice
but some think students should be able to choose what they eat	Student choice
but some think that the students should have a choice about what they want to eat	Student choice
but I understand certain individuals and groups think children should have complete choice of either junk or good food	Student choice
but I understand the argument that students should be able to chose what they eat	Student choice
but student will always want a choice about what they can buy in the way of snacks	Student choice
but they should allow students to choose what they eat by bringing their own snacks if they want	Students can still bring/access junk food
but children should be allowed to choose to bring with them whatever foods or snacks they please	Students can still bring/access junk food
but kids should be able to bring it if they choose to eat it	Students can still bring/access junk food
but if children choose to bring it in their lunch that is on them	Students can still bring/access junk food
but if kids choose to bring so on their own, that is their family's decision	Students can still bring/access junk food
but students should still have the freedom to bring snacks to school for lunch, everyone has a right to eat what they choose	Students can still bring/access junk food
but it is the parents and the student's choice to eat junk food as they want to	Students can still bring/access junk food
but let it be brought in from home if they choose	Students can still bring/access junk food
but allow students to bring in whatever foods their family allows	Students without choice
but should allow children to bring it in their lunch boxes if their parents send it in their lunch	Students without choice
but should allow kids to bring it from home	Students without choice
but should allow kids to have a say in selecting their own foods	Students without choice
but they should allow kids to bring their own if they want	Students without choice
but they should allow students to bring whatever food they wish to consume from home, as long as the school makes an effort to educate students about the risks of unhealthy eating habits	Students without choice
but kids are fond of junk foods	Students without choice
but kids are going to find a way to get what they want	Students without choice
but students are free to bring anything they want from home	Students without choice
but they are allowed to bring it themselves	Students without choice
but All food, ANY FOOD, can be a part of a healthy diet	Students without choice
but there could be an argument for teaching kids to make decisions in the face of temptation by allowing the food to remain	Students without choice
but students may be allowed to bring one serving of such with parental approval and no trading off with other students	Students without choice
but it should be noted that every child has their own personal decision of what they want to eat	Students without choice
but it should be the choice of the child or parent if they want them eating that	Students without choice
but it should ultimately be up to the individual or their guardian to decide what they want to eat	Students without choice
but kids should be able to bring junk food from home if that is what they and their parents want	Students without choice
but kids should be allowed to bring it on site to eat themselves	Students without choice
but kids should still be allowed to bring their own junk food if they want to	Students without choice
but parents should be allowed to pack whatever they want in their children's lunches	Students without choice
but should be allowed it at home	Students without choice
but students should be able to bring their own lunch into school	Students without choice
but students should be able to bring their own snacks if they want that	Students without choice
but students should be allowed to bring it to school	Students without choice
but students should be allowed to bring junk food if the parents provide it	Students without choice
but students should be allowed to bring junk food to campus if they desire	Students without choice
but there should be some options to what the students can buy	Students without choice
but they should be able to on certain occasions	Students without choice
but they should be allowed to bring it from home	Students without choice
but they should be allowed to bring it from home if the parents allow it	Students without choice
but snacks would be okay in moderation	Students without choice
but some believe that these children deserve more variety	Students without choice
but kids can bring in whatever they like	Students without choice
but students can bring whatever they want from home for lunch, which could include junk	Students without choice
but they can bring it from home	Students without choice
but kids could bring a lunch from home	Students without choice
but students may bring it anyway	Students without choice
but kids will still bring in unhealthy food	Students without choice
but students will still bring their own junk food	Students without choice
but if a student brings it from somewhere else it should be allowed	Students without choice
but if a student brings some in it is okay	Students without choice
but if a students brings it in his lunch, then he should be allowed to consume it	Students without choice
but many students continue to eat these unhealthy snacks	Students without choice
but if children decide to bring it from their own homes then it is on the child and the parent at that point	Students without choice
but If a parent decides to give junk food to a child for breakfast in the lunch box, it is their responsibility	Students without choice
but doing so would make for a happier student body, especially when they would suffer if they can't have access to junk food at school when they do at home	Students without choice
but if it there the children would eat with out the parents knowing	Students without choice
but it should also educate students and staff alike on why it has opted to do so	Students without choice
but it should educate students on the importance of nutrition and how it can affect them in life	Students without choice
but educating students about good food choices still needs to happen because they will have access to junk food off campus	Students without choice
but they should not express disapproval of children who bring junk food in their own lunches	Students without choice
but familes should have a say in what their kids eat	Students without choice
but They will just get it somewhere else or bring it from home	Students without choice
but students can have the option to eat it outside of school	Students without choice
but students do have the right for bring foods	Students without choice
but parents should ultimately have control over the decisions of their children	Students without choice
but they should have treats on special days	Students without choice
but this will not impact the nutrition they receive at home so there needs to be more education and support for parents who need help accessing health food	Students without choice
but they should inform the students as to why	Students without choice
but it is also important to focus on changing kids' fitness habits	Students without choice
but it is the children's decision to do whatever they want after they are not in school	Students without choice
but it is up to the student to bring it in their lunch	Students without choice
but junk food in moderation is acceptable if kids get enough exercise to burn off any excess calories and sugar consumption	Students without choice
but there is a great deal of resistance to this because that is what kids want and it is profitable	Students without choice
but there is no proper nutrition in the junk food to help growing children	Students without choice
but there is no way to stop students from bringing junk food from home	Students without choice
but ultimately it is up to parents to instill healthy beliefs in their kids	Students without choice
but ultimately it is up to the individual student what they eat or drink	Students without choice
but ultimately it is up to the students to make better choices and the educators and parent to teach the children how	Students without choice
but let students do what they want	Students without choice
but should also limit access to junk food to students	Students without choice
but should make an effort to teach the kids about better eating habits	Students without choice
but they should make sure that something is available to purchase if the children need to	Students without choice
but they should not penalize students who bring their own	Students without choice
but many kids prefer junk food	Students without choice
but they should not prohibit it if students bring it on their own	Students without choice
but also not punish students for possessing junk food, since it is readily available and does not constitute an inherent threat that would warrant harsh punishment	Students without choice
but it's worth noting that many students will still have easy access to it off campus	Students without choice
but parents can send junk food to school with their own child	Students without choice
but if its taken away, kids will find a way to bring it back to campus	Students without choice
but I think if they are allowed to only buy it once in awhile it would be fine	Students without choice
but I think they should be able to bring from home if wanted	Students without choice
but if people want it it, they will still find a way to have it	Students without choice
but if a student really wants junk food, they can make he more conscious decision to purchase their junk food at a local grocery store	Students without choice
but no way very students like that	Students without choice
but young people need guidance about their food decisions	Students without choice
but students can be told where they can buy the food at instead (i	Students without choice
but should be transparent about their reasoning and teach kids why unhealthy foods aren't good	Students without choice
but students will of course buy it off-campus	Students without choice
but it is the parents responsibility to try to teach their children about healthy eating/lifestyle	Students without choice
but cannot prevent children from getting junk food elsewhere	Students without choice
but we cannot protect our kids from everything bad for them out there	Students without choice
but if students want to bring in their own junk food lunches from home, the schools cannot control this	Students without choice
but many also admit that they do not incorporate enough exercise into their daily routines	Unclassified Off-Topic
but maybe only allow it during certain times of the day	Unclassified Off-Topic
but might allow some junk food on special occasions	Unclassified Off-Topic
but in the long run, a person's health choices are personal, and government institutions should not be able to dictate such choices	Unclassified Off-Topic
but treats from time to time are ok and should be allowed, i	Unclassified Off-Topic
but in some cases junk food can be sold once a month	Unclassified Off-Topic
but it could be limited	Unclassified Off-Topic
but It could potentially be sold in moderation and let kids make their own choices	Unclassified Off-Topic
but on special occasions and in limited amounts it could potentially be acceptable such as Valentines, Halloween, and like occasions	Unclassified Off-Topic
but there could be certain times or events where some junk food may be purchased	Unclassified Off-Topic
but any kind of sweets should be part of an overall balanced meal such as served in a Cafeteria	Unclassified Off-Topic
but should be available for sale in the general marketplace	Unclassified Off-Topic
but it will be sold anyway, due to it being cheaper	Unclassified Off-Topic
but, this would be acceptable for sports related events	Unclassified Off-Topic
but a couple options for junk food would be ok	Unclassified Off-Topic
but could consider selling them at sporting or extra curricular events	Unclassified Off-Topic
but if a club or organization has a fundraiser it may be allowed on special occasions	Unclassified Off-Topic
but could have places near by that do sell it but that are not as convenient	Unclassified Off-Topic
but everybody should have the right to sell or buy or eat as they please	Unclassified Off-Topic
but parents should also have a say in what their children eat	Unclassified Off-Topic
but if it is brought from home than it is ok	Unclassified Off-Topic
but if it is sold it should be really expensive so that only people that really want junk food will buy it	Unclassified Off-Topic
but is not good for their health	Unclassified Off-Topic
but it is acceptable to eat it there	Unclassified Off-Topic
but it is cheap quick and convenient	Unclassified Off-Topic
but it is ok if their parents pack a lunch that contains junk food	Unclassified Off-Topic
but jthere is no but	Unclassified Off-Topic
but only if it is limited to certain items	Unclassified Off-Topic
but the parents need to to keep an eye on what their children are eating as well	Unclassified Off-Topic
but it needs to follow through at home with their own families	Unclassified Off-Topic
but this still needs to be encouraged off campus too	Unclassified Off-Topic
but parents should also provide education and rules at home around food choices	Unclassified Off-Topic
but that will not stop the problem on its own	Unclassified Off-Topic
but maybe use them as a reward	Unclassified Off-Topic
but DUST IN NOSE	Unclassified Off-Topic
but ITS NOT GOOD	Unclassified Off-Topic
but its not healthy	Unclassified Off-Topic
but maybe a few things	Unclassified Off-Topic
but maybe on certain special occasions or at events	Unclassified Off-Topic
but only during certain speical days	Unclassified Off-Topic
but so good	Unclassified Off-Topic
but SOLD ON	Unclassified Off-Topic
but it should be allowed to be sold off-campus and they can bring their junk food onsite if desired	Unclassified Off-Topic
but that doesn't mean they shouldn't have so called "junk" food every once in a while	Unclassified Off-Topic
but it's understandable that they are currently providing food that is in high demand (i	Unclassified Off-Topic
but Junk food's companies won't like that	Unclassified Off-Topic
butter wonâ€™t be healthy	Unclassified Off-Topic
